Entity Name;Total Premium 2022;Total Premium 2021;Total Premium 2020;Standalone Premium 2022;Standalone Premium 2021;Standalone Premium 2020;Package Premium 2022;Package Premium 2021;Package Premium 2020;Wiki Text;Year Founded;Founded By;Year Sold;Acquired By;Ceassed Business;;Note
Indian Harbor Ins Co;461711497;293280380;169376497;461711497;293280380;169376497;0;0;0;"The company was incorporated in 1992 in North Dakota for the purpose of engaging in the property and casualty insurance business. It is a subsidiary of XL Specialty Insurance Company and an indirect subsidiary of XL Reinsurance America Inc. In 2013, the company re-domesticated from North Dakota to Delaware with regulatory approval. In September 2018, AXA S.A. became the ultimate parent of AXA XL Group and its affiliates through a merger with XL Group Ltd.

XL Reinsurance America Inc. owns 100% of XL Specialty, Greenwich Insurance Company, and Catlin Specialty Insurance Company. XL Specialty owns 100% of IHIC and Catlin Insurance Company, Inc. Greenwich Insurance Company owns 100% of XL Insurance America Inc., which in turn owns 100% of XL Select Insurance Company and XL Insurance Company of New York, Inc.

The company's capitalization includes 50,000 shares of common stock with a par value of $100. As of December 31, 2020, all 50,000 shares were issued and outstanding, totaling $5,000,000. All outstanding shares are owned by XL Specialty. The company reported gross paid-in and contributed surplus of $103,918,879.

The company received several capital contributions from its parent, XL Specialty, including $30,000,000 in December 2020, $15,000,000 in June 2020, $8,000,000 in March 2020 and December 2018, $5,000,000 in November 2017, and $1,000,000 in March 2016.";1993;;2020;AXA;N/A;;
Ace Amer Ins Co;459961881;357344065;297782820;0;0;0;459961881;357344065;297782820;"ACE Limited has completed its acquisition of Chubb, creating the world's largest publicly traded property and casualty insurance company. The transaction, totalling $29.5bn in cash and stock, includes the transfer of the Chubb name globally. The new Chubb brand will begin trading under the symbol “CB” on the New York Stock Exchange. Fitch Ratings has placed a number of the financial strength (IFS) ratings of ACE’s operating subsidiaries under review following the merger. The rating agency has stated that it will “…review how this transaction may enhance or adversely affect the individual standalone ratings of these ACE subsidiaries”, including ACE Seguros, life subsidiary BBA and life reinsurer, ACE INA Holding Inc. The new company will start operations from Friday, consolidating underwriting offices in London and Bermuda. The combination is expected to open new growth opportunities in the US market, but analysts are predicting cost savings could put thousands of jobs at risk worldwide.
";2016(merger);;;Chubb(merger);N/A;;
Arch Specialty Ins Co;313795174;117898677;8809952;299577670;110881802;7486790;14217504;7016875;1323162;"Arch Capital Group, a company that specializes in reinsurance, insurance, and mortgage insurance, has been expanding its operations since its launch in 2001. In 2002, the company brought in $1.26 billion in net premiums written. It continued to grow and open offices in Toronto, Canada and London, England by 2005. In 2019, the company acquired the UK commercial lines business of the Ardonagh Group and launched its primary mortgage insurance operations in Australia. It also started underwriting property and casualty, motor, and other business lines through its EU arm in Ireland. 

ACE Limited has completed its acquisition of Chubb, creating the largest publicly traded property and casualty insurance company in the world. The acquisition was valued at $29.5 billion and included the transfer of the Chubb name globally. The new company will operate under the Chubb brand and will begin trading on the New York Stock Exchange. The combination is expected to create new growth opportunities in the US market, but there are concerns that cost savings from the merger could result in job cuts worldwide. Fitch Ratings has placed the financial strength ratings of ACE's subsidiaries under review following the merger, to assess how it may impact their individual ratings.";2001;;;;;;
Houston Cas Co;280339800;167127159;18048575;238595172;151837525;12880117;41744628;15289634;5168458;Tokio Marine Holdings agreed to acquire US insurer, HCC Insurance Holdings, for $7.5bn in cash. The deal will expand Tokio Marine's product offerings and capabilities, as well as providing it with an international footprint. It will also strengthen the non-life insurer’s position in the US, the world's biggest market. Nikkei added that the acquisition, if completed, would lift Tokio Marine up from 12th place to eighth or ninth among global insurers in terms of capital. As we highlighted last month, the ageing population of Japan is believed to be eroding the profitability of local insurers, including the four largest in Japan - Tokio Marine, Nippon Life Insurance, Meiji Yasuda Life Insurance, and Dai-ichi Life Insurance - and pushing them to seek growth opportunities overseas. Tokio Marine said the offer represents a 38% premium to HCC’s closing price on Tuesday and they are hoping to close the deal, which is subject to approval by HCC’s shareholders and regulators, in Q4 2015.;1974;;2015;Tokio Marine Holdings;;;
United States Fire Ins Co;274966499;184953020;7727419;274966499;184953020;7727419;0;0;0;Based in Morristown, New Jersey, the United States Fire Insurance Company has been offering a wide range of insurance services since its establishment in 1824. These services include health, automobile, burglary, and fire insurance, along with underwriting services. A subsidiary of Crum & Forster Holding, the company's assets are guided and maintained by its board of directors.;1824;;;;;;
Travelers Cas & Surety Co Of Amer;250814827;186581727;166328918;250814827;186581727;166328918;0;0;0;Based in Hartford, Connecticut, Travelers Casualty and Surety Company was founded in 1883. The company, a subsidiary of Travelers Insurance, provides various insurance services including property, aircraft, automobile, credit, fire, and casualty insurance.;1974;;;;;;
AIG Specialty Ins Co;246477546;175567623;52736953;246477546;175567623;52736953;0;0;0;"AIG Specialty Insurance Company, formerly known as Alaska Insurance Company and Chartis Specialty Insurance Company, is a subsidiary of American International Group (AIG). It was incorporated in Alaska in 1973, changed its name to American International Surplus Lines Insurance Company in 1989, and re-domesticated to Illinois in 2007. The company finally adopted its current name in 2013. AIG Specialty operates as a non-admitted insurer in 49 states and the District of Columbia.

AIG Specialty participates in an intercompany pooling agreement with 11 other affiliates, including National Union Fire Insurance Company, American Home Insurance Company, and Lexington Insurance Company. Under this agreement, AIG Specialty cedes 100% of its premiums to National Union but does not receive a share of the pool's combined results. The financial strength of AIG Specialty is heavily dependent on the underwriting performance of its pool members, the credit risk of AIG, and its own investment portfolio.";1973;;;;;;
Endurance Amer Specialty Ins Co;204486873;87949226;23508352;204486873;87949226;23508352;0;0;0;"Sompo Holdings has completed its acquisition of Endurance Specialty Holdings for $6.3bn. The deal, which was announced in October 2016, has received approval from regulatory authorities and has met other closing conditions. As a result of the acquisition, Endurance will become part of Sompo Holdings, with a new entity called Sompo International being created in Bermuda. Sompo International will serve as a global commercial insurance and reinsurance platform. It will also incorporate Sompo Holdings' existing international commercial insurance and reinsurance businesses. The integration aims to provide customers with a wide range of insurance products across global markets. All Endurance business, with the exception of ARMtech, will be conducted under the Sompo International brand. Sompo America and SJNK Europe will also be rebranded Sompo International, although Sompo Canopius will remain a separate brand working closely with Sompo International. The new entity will have its own board, led by John Charman as chairman and CEO. The completion of the acquisition will enhance Sompo's presence in international markets and provide opportunities for global diversification.
";1982;;2017;Sompo Holdings;;;
Scottsdale Ins Co;175861820;4195340;1740639;175815687;4172214;1689197;46133;23126;51442;"Nationwide has announced the completion of the rebranding of Scottsdale Insurance Company to Nationwide. The company will continue to offer excess & surplus and specialty solutions as the E&S/Specialty business unit. Nationwide made the decision in September 2014 to convert all of its operations to leverage its strongest brand asset, ""Nationwide is on your side."" The rebranding will combine the strength of Nationwide's brand with the expertise of its E&S/Specialty team to fuel growth and strengthen the company's position in the industry. Agents and brokers in the excess & surplus and specialty marketplace will benefit from the stability of a Fortune 100 company with superior credit ratings, as well as the agility and responsiveness of a niche insurance carrier. Nationwide's E&S/Specialty team will continue to underwrite products with Scottsdale Insurance and affiliated companies and will remain in Scottsdale, Arizona. The Scottsdale campus is home to around 1,500 associates who support various Nationwide business lines. Nationwide is committed to maintaining its values and providing specialized solutions for its agency partners.";1982;;2014;Nationwide;;;
Steadfast Ins Co;174469544;114208060;39700948;152389874;100125383;33812353;22079670;14082677;5888595;N/A;1996;;;;;;
Beazley Ins Co Inc;166761417;192838721;171187235;164880944;191046521;168813830;1880473;1792200;2373405;Beazley is a global specialist insurance company that provides its services to clients worldwide. Part of the Lloyd's market ecosystem, Beazley has a significant presence through Lloyd's broker network. This network and the market's trading licenses grant Beazley ample access to insurance and reinsurance businesses globally.;1996;;;;;;
Accredited Specialty Ins Co;159353010;23939093;0;159353010;23939093;0;0;0;0;Accredited Holding Corporation has signed a merger agreement with a subsidiary of Randall & Quilter America Holdings. Accredited is the holding company for Accredited Surety and Casualty Company, a specialist insurer based in Florida. Accredited Surety holds active licenses in 49 US states and the District of Columbia, is listed by the Treasury, and has received an A- rating from A.M. Best. The company is a leading provider of bail bond insurance in the US and has a strong network of high-quality agents. Following the merger, Accredited will continue to be led by its existing management team, including Deborah Snow as President and CEO, Sharon Jallad as COO, Marney Emel as CFO, and AJ Campofiore as Chief Business Development Officer. The merger will enable Accredited to benefit from the resources and support of Randall & Quilter, a global provider of insurance and reinsurance services. The merger agreement marks an important milestone for Accredited and positions the company for further growth and success in its specialist insurance markets.;2020;Accredited Holding Corporation;2014;andall & Quilter Investment Holdings;;;Parent company acquired in 2014, but founded in 2020
Ascot Specialty Ins Co;132476883;35661275;7625944;71775475;1640922;222273;60701408;34020353;7403671;Ascot Specialty Insurance Company, originally known as Frontier Insurance Company, was incorporated in Rhode Island in 1974. It went through several name changes, becoming Coventry Insurance Company in 1986 and then going dormant in 1989. In 2017, it was acquired by Greyhawk Insurance Company and renamed Greyhawk Specialty Insurance Company. Later in 2018, Greyhawk Insurance Company and Greyhawk Specialty Insurance Company were both acquired by Ascot US Holding Corporation, a subsidiary of Ascot Group, Ltd, which is fully owned by the Canada Pension Plan Investment Board. The company was revitalized and recapitalized in 2018 to expand its business writing in the fields of Environmental Liability, Professional Lines, Mergers and Acquisition, and Property. This expansion is made possible through its Lloyds syndicate 1414 and its programs and program business. Ascot Specialty obtained eligibility in New York in May 2019 and is currently licensed in Rhode Island. It is eligible to write surplus lines insurance in forty-nine states and the District of Columbia.;1974;;2018;Ascot Group;N/A ;;
North Amer Capacity Ins Co;131246275;71719202;17169075;131246275;71719202;17169075;0;0;0;North American Capacity Insurance Company (North American Capacity) was originally founded as American Capacity Insurance Company in Illinois in March 1986. It became a subsidiary of RLI Corporation and then was acquired by Swiss Re Limited in January 1991. After the acquisition, the company changed its domicile to New Hampshire and adopted its current name in May 1991. Under Swiss Re, North American Capacity is now a wholly owned subsidiary of Westport Insurance Corporation. The company has been authorized to provide surplus lines insurance in New York since August 10, 1992. As of December 31, 2021, North American Capacity is a domestic surplus lines insurer in New Hampshire and holds a license as an admitted insurer in Illinois. It operates on a non-admitted basis in forty-eight states, the District of Columbia, Puerto Rico, and the U.S. Virgin Islands.;1986;RLI Corporation;1992;Swiss Re ;N/A ;;
BCS Ins Co;122045690;132043119;86582699;69880468;75114522;49976873;52165222;56928597;36605826;BCS Insurance Company, also known as BCS Insurance, is an Illinois-based insurer located in Oakbrook Terrace. Founded in 1950, this company offers a range of insurance products such as automobile, disability, liability, and marine insurance. BCS Insurance Company operates as a subsidiary of the BCS Financial Corporation and is guided by a board of trustees.;1950;;;;;;
Landmark Amer Ins Co;120465953;82485327;15515363;120465953;82485327;15515363;0;0;0;Landmark American Insurance Company (Landmark American) was originally incorporated in the State of Oklahoma in February 1976. After a series of acquisitions, it came under the ownership of Guaranty National Corporation in 1980 and later Royal & SunAlliance USA, Inc. in November 1999. Since September 2003, Alleghany Corporation has held financial control over the company. In October 2016, Landmark American re-domesticated to New Hampshire.Beginning on September 4, 1991, Landmark American became eligible to write surplus lines business in New York. As of December 31, 2021, it operates as a New Hampshire-based domestic surplus lines insurer. The company conducts non-admitted operations in forty-nine states, including the District of Columbia, American Samoa, Puerto Rico, and the U.S. Virgin Islands.;1976;;2003;Alleghany Corporation;N/A ;;
Continental Cas Co;111686716;106204573;76682220;9490768;8367022;6887204;102195948;97837551;69795016;Continental Casualty Company provides property and casualty insurance underwriting services to a wide variety of businesses and professionals. The company was established in 1897 with the initial purpose of offering accident and disability insurance for employees in the railroad industry.As of the close of 2014, CCC, along with its subsidiaries, reported a statutory surplus of $11.2 billion.;1897;;;;;;
Associated Industries Ins Co Inc;111589195;49324680;0;111574941;49312393;0;14254;12287;0;Associated Industries Insurance Company, originally known as Southeastern Surety Company, was formed in Florida in October 1953. Over the years, it underwent several name changes and operational transitions. It became Southeast Title and Insurance Company in 1959 and operated as Associated Industries of Florida Property & Casualty Trust, a domestic commercial self-insurance fund, from 1987 to June 1996. The company was acquired by Associated Industries Insurance Services, Inc. in December 1994 and officially adopted its current name in January 1996. Since September 2007, AmTrust Financial Services, Inc. has held financial control of the company. As of June 12, 2012, Associated Industries became authorized to provide surplus lines insurance in New York. Currently, the company holds licenses in Florida and operates as a non-admitted insurer in forty-nine states and the District of Columbia.;1953;;2007;AmTrust Financial Services;N/A ;;
AXIS Surplus Ins Co;107798664;72510031;16129117;101946464;66896623;11809679;5852200;5613408;4319438;AXIS Surplus Insurance Company (AXIS Surplus) was originally established as Sheffield Insurance Company in November 1986 in Alabama. It later changed its name to Sheffield Insurance Corporation in 1987. In June 1992, the company was acquired by Combined Specialty Group, Inc. and then re-domesticated to Illinois in January 2000. AXIS Capital Holdings Limited acquired the company in February 2003 and it subsequently adopted its current name. The company became eligible to write surplus lines business in New York on October 31, 2003. As of December 31, 2021, AXIS Surplus is an approved surplus lines insurer in fifty states, the District of Columbia, and Puerto Rico, operating as an Illinois domestic surplus lines company.;1983;;2003;AXIS Capital;N/A;;
Columbia Cas Co;104015443;62872693;31772069;17256584;13782851;10954074;86758859;49089842;20817995;"Columbia Casualty Company, initially established as Columbia Fire Insurance Company in Nebraska in February 1900, ceased operations in 1912. In 1919, the corporate charter was transferred to the National Fire Insurance Company of Hartford. Then, in 1973, the charter was sold to Continental Casualty Company, the parent company of National Insurance Company of Hartford. To reactivate the charter and change the company's domicile, Columbia Casualty Company of Illinois was incorporated in March 1974. It subsequently dropped the ""Illinois"" from its title and became Columbia Casualty Company. Continental Casualty Company, in turn, is owned by CNA Financial Corporation, with 90% ownership by Loews Corporation. Columbia Casualty has been authorized to write surplus lines business in New York since 1989. As of December 31, 2021, Columbia Casualty is an Illinois-based surplus lines insurer operating on a non-admitted basis in forty-nine states, the District of Columbia, and Puerto Rico.";1900;;1974;Loews Corporation (CNA) ;N/A ;;
HSB Specialty Ins Co;96971760;101315497;15414807;0;0;15414807;96971760;101315497;0;German reinsurance company Munich Re has agreed to acquire specialty insurer HSB Group from American International Group (AIG) for $742m. The acquisition is part of Munich Re's strategy to expand its presence in the US insurance market. HSB Group, headquartered in Connecticut, is a subsidiary of AIG and is known for providing machinery and equipment breakdown insurance, inspection, certification, and engineering consulting services. In 2007, HSB posted an after-tax profit of $158m and had a gross written premium income of $904m. Munich Re will fund the purchase entirely from existing resources and the transaction is expected to be completed by the end of Q1 2009, subject to regulatory approval. After the acquisition, HSB will be under the direct operating control of Munich Re America. Munich Re believes that the acquisition of HSB will help reduce the volatility of traditional reinsurance business and strengthen its position in high return specialised niche segments;2012;AIG;;Munich Re;;;
Palomar Excess & Surplus Ins Co;95125771;7022260;0;95125771;7022260;0;0;0;0;Palomar Excess & Surplus Insurance Company (PESIC) was established as an Arizona-based surplus lines insurer in the second quarter of 2020. It obtained regulatory approval during the same period and began operations with an initial surplus of approximately $102.4M. PESIC holds authorization to underwrite all property and casualty insurance business on a non-admitted basis. PESIC operates as a direct wholly owned subsidiary of Palomar Insurance Holding, Inc. (PIH), a Delaware corporation. PIH, in turn, is wholly owned by Palomar Holdings Inc (PHI), and also owns Palomar Specialty Insurance Company (PSIC) and Palomar Insurance Agency, Inc., operating as Prospect General Insurance Agency, Inc. (PGIA). PSIC, domiciled in Oregon, is the primary operating subsidiary and is licensed as an admitted insurer in 30 states. PGIA is a managing general agency responsible for underwriting specialty insurance products for PSIC, PESIC, and third-party insurance companies. ;2020;Palomar Insurance HOlding ;N/A;N/A;;;Founded in 2020
Homeland Ins Co of NY;93166897;44405177;399095;92262559;44172506;66117;904338;232671;332978;Homeland Insurance Company of New York, headquartered in Canton, Massachusetts, was founded in 1988 as an insurance provider, specializing in property and casualty coverage. It functions as a subsidiary of OneBeacon Insurance Group.;1988;;;;;;
Allied World Specialty Ins Co;92624349;78878056;32343233;92624349;78878056;32343233;0;0;0;The business that is now known as Allied World Specialty Insurance Company has gone through a series of name changes and acquisitions since its inception. It was first incorporated in North Carolina on January 14, 1972, as Peninsula Property and Casualty Company (PPCC). It eventually became known as Darwin National Assurance Company (DNA). On October 20, 2008, the company, then named DPUI, was purchased by Allied World Insurance Company (AWIC) from a company called AIH. After this acquisition, it was rebranded as AW Underwriters, Inc. (AWUI). The company is a fully-owned subsidiary of AWUI, and completely owns two Arkansas-based insurance companies: Allied World Surplus Lines Insurance Company (AWSLIC), previously known as both Darwin Select Insurance Company and Vantapro Specialty Insurance Company. The company adopted its current name, Allied World Specialty Insurance Company, on October 28, 2014. It's parent company, Allied World Assurance Company is a Fairfax subsidiary. ;1972;General Electric;2017;Fairfax ;;;
Liberty Surplus Ins Corp;87787448;44345914;11763732;87787448;44345914;11763732;0;0;0;Liberty Surplus Insurance Corporation (Liberty Surplus) was established in June 1997 in New Hampshire as a subsidiary of Liberty Mutual Holdings Company, Inc. (LMHC). Financial and operational control of the company is maintained by LMHC. Since August 28, 1998, Liberty Surplus has been authorized to provide surplus lines insurance in New York. As of December 31, 2021, Liberty Surplus is licensed in New Hampshire and operates on a non-admitted basis in 49 states, the District of Columbia, Guam, Puerto Rico, and the U.S. Virgin Islands. ;1997;Liberty Mutual Holdings Company;N/A;N/A;;;
Allied World Assur Co US Inc;83807378;41756936;18753340;83807378;41756936;18753340;0;0;0;Allied World Assurance Company Holdings, Ltd. is a global provider of insurance and reinsurance products. In 2017, Allied World was acquired by Canadian financial holdings company, Fairfax Financial Holdings Limited. It now operates around the world as a Fairfax subsidiary.;;;2017;Fairfax ;;;
Axis Ins Co;80964638;79579110;117420667;58816740;70087236;78035933;22147898;9491874;39384734;Established in 1979, AXIS Insurance Company provides a diverse range of insurance services, including aircraft, automobile, property and casualty, professional lines, terrorism, marine, energy, aviation, accident, health, and life insurance to its customers. Based in Alpharetta, Georgia, the company is a subsidiary of AXIS Capital Holdings. The board of directors oversees the management of the company's assets.;1979;Axis Capital Holdings Ltd;;;;;
Everest Natl Ins Co;77710793;50874360;26923358;77710793;50874360;26923358;0;0;0;;1973;Prudential Financial;;;;;
Illinois Union Ins Co;67178962;45340999;36583151;0;0;0;67178962;45340999;36583151;"Illinois Union Insurance Company, formerly known as GATX Insurance Company, is a subsidiary of ACE American Insurance Company and operates under the Chubb group. It is based in Illinois and has been eligible to write surplus lines business in New York since 1989. As of December 2021, Illinois Union is a domestic surplus lines insurer in Illinois and operates on a non-admitted basis in 49 states and the District of Columbia.

Illinois Union participates in the 25-member intercompany Chubb Pool where it cedes business to Federal Insurance Company. Reinsurance for the pool is complex and flows through various intercompany and non-affiliate layers managed by Chubb. Therefore, the financial strength of Illinois Union depends heavily on the credit risk of Chubb and the investment risk of its own portfolio managed by Chubb.

Chubb is a globally recognized insurance holding company that was founded in 1882 and has operations in 54 countries and territories. In 2016, ACE Ltd, which was founded in Bermuda in 1985 and later domiciled in Switzerland, acquired the Chubb Group and merged the two entities. The rebranded group, Chubb, is one of the largest publicly traded insurance holding companies in the world. Chubb provides commercial and personal property and casualty insurance, personal accident and supplemental health insurance, reinsurance, and life insurance to a diverse range of clients.

AM Best rates both Chubb and its insurance subsidiaries, including Illinois Union Insurance Company. Chubb has consistently received high ratings from AM Best and S&P, with an 'A++'/'AA' rating and a financial size of XV ($2 billion and above) for the years 2018 through 2021.

Overall, Illinois Union Insurance Company operates as part of the strong and globally recognized Chubb group, benefiting from its financial strength and reputation in the insurance industry.";1989;Ace Amer;;;;;
Westfield Specialty Ins Co;63263319;7535165;0;33975874;0;0;29287445;7535165;0;In 2020, Westfield Specialty Insurance Company (WSIC) was established as a surplus lines insurer based in Ohio. It began operating in the first quarter of 2021 with an initial capital base of $50 million. As a wholly owned subsidiary of Ohio Farmers Insurance Company Inc. (OFIC), WSIC operates as a stock insurance company. WSIC conducts business as a nonadmitted insurer in all U.S. states and the District of Columbia, with the exception of Iowa. ;2020;WSIC;N/A;N/A;;;Founded in 2020
QBE Specialty Ins Co;62064382;36271448;3505604;62064382;36271448;3505604;0;0;0;In September 2008, Arch Specialty Insurance Company (Arch Specialty) was established as a New York domiciled insurer. Financial and operational control of the company rests with its ultimate parent, Arch Capital Group Ltd. (Arch Capital), a Bermuda-based public company. Arch Specialty is authorized to provide surplus lines insurance in New York since February 27, 2009. As of December 31, 2021, Arch Specialty maintains its license as an excess and surplus lines insurer in New York, while operating as a non-admitted insurer in all other U.S. states and the District of Columbia. Arch Specialty actively participates in various treaties and facultative reinsurance programs to manage its risk exposures. ;2002;QBE Insurance Corporation;N/A;N/A;;;
Berkley Assur Co;59948765;48543227;20734343;59946465;48539408;20723981;2300;3819;10362;Berkley Assurance Company, originally known as Florida International Indemnity Company, was established in Florida in May 1980. It went through various name changes - Queensway International Indemnity Company (1997-2004) and North Pointe Casualty Insurance Company (2004-2010). During the latter period, it functioned as a subsidiary of North Pointe Holdings Corporation. It was acquired by W. R. Berkley Corporation (Berkley), and assumed its current name, on January 1, 2011. The company's base was moved to Iowa as of March 2011. Berkley Assurance has been sanctioned to undertake surplus lines business in New York since September 19, 2011. As at the end of 2021, it is licensed in Iowa and operates without admission in 49 states and the District of Columbia.;1980;;2011;W.R. Berkley Corporation;N/A;;
Greenwich Ins Co;51749047;119313234;120988991;51749047;119313234;120988991;0;0;0;;;;;;;;
Aspen Specialty Ins Co;51378445;29883659;21811342;51378445;29883659;21811342;0;0;0;Aspen Specialty Insurance Company, also known as Aspen Specialty, was originally incorporated in North Dakota in September 1996. Initially, it was called Dakota Specialty Insurance Company and operated as a subsidiary of The Insurance Corporation of New York. In September 2003, Aspen Insurance Holdings Limited (Aspen Holdings) acquired the company which consequently resulted in the adoption of its current name. Since April 13, 2004, the company has had the authorization to conduct surplus lines business in New York. As of the end of 2021, Aspen Specialty operates as a domestic surplus lines insurer established in North Dakota. It operates on a non-admitted basis across 49 states and the District of Columbia.;1996;The Insurance Corporation of New York;2003;Aspen Insurance Holdings Limited;N/A;;
Swiss Re Corp Solutions Amer Ins Co;50520699;0;0;50520699;0;0;0;0;0;;;;;;;;
Allianz Global Risks US Ins Co;46484716;35284678;11530464;5300085;6153156;10326915;41184631;29131522;1203549;;1977;;;;;;
Allied World Surplus Lines Ins Co;41017172;15475448;1881213;41017172;15475448;1881213;0;0;0;Allied World Surplus Lines Insurance Company, known as AW Surplus Lines, was originally incorporated in Delaware in December 1990 under the name Ulico Indemnity Insurance Company, as a subsidiary of the Ulico Casualty Company. By 1992, it had shifted its domestic base to Arkansas. The company was later bought by Darwin National Assurance Company in May 2005, adopting the name Darwin Select Insurance Company. In October 2008, the company was acquired by Allied World Assurance Company Holdings, AG or AW Holdings. AW Surplus Lines adopted its current identity in June 2014. Fairfax Financial Holdings, Ltd bought AW Holding in July 2017. AW Surplus Lines got the clearance to transact surplus lines business in New York in February 2008. As of December 31, 2021, AW Surplus Lines, based in Arkansas, operates as a non-admitted insurer in forty-nine states and the District of Columbia.;1990;Ulico Casualty Company;2017;Fairfax ;;;
The Cincinnati Ins Co;39185706;30766840;21181483;0;0;0;39185706;30766840;21181483;;;;;;;;
Zurich Amer Ins Co;37502072;37350411;24364754;36633239;36198675;23452881;868833;1151736;911873;Zurich American Insurance Company was established under New York state law on June 3, 1998, and kicked off its operations on December 31, 1998. It was founded to serve as the domestication medium under Article 72 of the New York Insurance Law for the U.S. branch of Zurich Insurance Company. On December 31, 1998, all assets and liabilities of the branch were transferred to the Company, consequently ending the branch's existence. Zurich American is the flagship company in the Zurich American Insurance Group. It is based in New York but operates its headquarters in Schaumburg, Illinois. ZAIG, through its standalone legal entities, holds licenses in all 50 states, the District of Columbia, and several U.S. territories. It offers a variety of commercial insurance products and risk management services to both domestic and international companies. ZAIG manages its property and casualty insurance companies as one entity, thereby ruling out any operational or strategy-based distinction among the legal entities.;1998;Zurich;N/A;N/A;;;
Ascot Ins Co;34079555;28667638;4505665;2058120;1312808;355563;32021435;27354830;4150102;;1968;;;;;;
National Specialty Ins Co;33579318;11463868;710336;33419054;11412151;674876;160264;51717;35460;;1960;State National Insurance Company;;;;;
Westchester Surplus Lines Ins Co;33135464;18151579;14119771;0;0;0;33135464;18151579;14119771;"ACE Limited has announced the leadership team that will be appointed for its North America excess and surplus (E&S) lines wholesale business upon the completion of its acquisition of Chubb. The business will be named Westchester, a Chubb company, and will include wholesale business currently written in ACE Westchester, ACE Commercial Risk Services, Chubb Custom Market, Chubb Specialty Insurance, and Chubb Commercial Insurance. The acquisition is expected to close in the first quarter of 2016.

Bruce Kessler will serve as Senior Vice President of the new Chubb Group and Division President of Westchester, responsible for integrating the E&S, small commercial, and programs businesses within ACE and Chubb. David Lupica will serve as Chief Operating and Distribution Management Officer, with responsibility for the small commercial group. Westchester will focus on the Property, Casualty, Professional Risk, Inland Marine, Environmental, and Product Recall lines of business for wholesale distribution partners.

The leadership team for Westchester will consist of Bob Meyer, Dean Andrighetto, Joseph Casey, Rob Owens, and Florian Beerli, who will lead various lines of business. In the small commercial group, David Charlton will lead the Micro Specialty business, and Franklin Sanders, Jr. will lead the Programs business.

The company aims to broaden its capabilities in the wholesale market, invest in new technologies, and build out its distribution. The leadership team is expected to generate strong results and achieve ambitious targets for growth and profitability. Westchester's commitment to the wholesale market is demonstrated by the addition of small business specialty and programs leadership, and it aims to position itself as the specialty insurer of choice for a wide range of challenging risks.";1971;Chubb;;;;;
Travelers Prop Cas Co Of Amer;33044763;29033905;26991625;0;0;0;33044763;29033905;26991625;;1971;The Travelers Indemnity Company;;;;;
Arch Ins Co;32577868;20239098;7233460;23565826;14666670;3480274;9012042;5572428;3753186;;2002;Arch Capital Group;;;;;
Scottsdale Ind Co;30408087;3820837;1431728;30363317;3806074;1426938;44770;14763;4790;;1984;;;Nationwide;;;
Philadelphia Ind Ins Co;30058282;26476567;28376370;21363536;20444495;23648992;8694746;6032072;4727378;;1927;Philadelphia Insurance Companies;2008;Tokio Marine;;;
Hartford Underwriters Ins Co;29950889;13390555;6234118;0;0;0;29950889;13390555;6234118;;;;;;;;
Allianz Underwriters Ins Co;28647591;13182507;5307707;17617528;1884159;5303457;11030063;11298348;4250;;1980;;;;;;
Hiscox Ins Co Inc;28434938;23066657;15345237;28194777;22749428;14321485;240161;317229;1023752;;1901;;;;;;
Canopius US Ins;27827389;0;0;27827389;0;0;0;0;0;;2003;;;;;;
Twin City Fire Ins Co Co;27551937;23199977;20942078;14730555;12190640;5361986;12821382;11009337;15580092;;1987;The Hartford;;;;;
Princeton Excess & Surplus Lines Ins;27296640;13417757;0;22766952;0;0;4529688;13417757;0;Princeton Excess & Surplus Lines Insurance Company, also known as Princeton E&S, was founded and incorporated in Delaware in June 1995. Initially, it was created as a subsidiary under the name of The Princeton Excess & Surplus Lines Insurance Corporation, which was a part of the American Re Corporation. The company renamed itself to the present name in December 1995 and came under the financial control of Munich Re in August 1996. The organisation was given the green light to write surplus lines business in New York starting October 7, 2003. As of the last day of 2021, Princeton E&S, now a domestic surplus lines insurer of Delaware, works on a non-admitted basis in 49 states other than Delaware, including the District of Columbia.;1995;American Re;1996;Munich Re;;;
Allied World Natl Assur Co;26922595;17197686;7182700;26922595;17197686;7182700;0;0;0;The Allied World National Assurance Company (AW National) was first incorporated in New Hampshire in September 1996, going by the name of Newmarket Underwriters Insurance Company, as a subsidiary of Swiss Reinsurance Company. It was later purchased by Allied World Assurance Company Holdings, AG in July 2002 and changed its name in August 2007. In 2017, the company was further acquired by Fairfax Financial Holdings Limited (Fairfax). AW National has been authorized to conduct surplus lines business in New York since June 1997. As of the end of 2021, the company is licensed in 44 states and the District of Columbia, while also operating on a non-admitted basis in California, Delaware, and New York.;1996;Swiss Re;2017;Fairfax ;;;
Evanston Ins Co;25700944;4265973;9697226;25700944;4265973;9697226;0;0;0;Evanston Insurance Company, known simply as Evanston Insurance, was established in Illinois in August 1977. From the time of its creation until 2015, no official company history was recorded. By 2015, it was owned by Markel Corp. (Markel). During this period, a series of consolidating mergers were carried out by Markel, where Altera E&S Insurance Company, Essex Insurance Company, and Associated International Insurance Company were integrated into Evanston Insurance in December 2015, June 2016, and December 2016 respectively. The financial and operational control of Evanston Insurance remains under Markel Corporation. The company has been authorized to engage in surplus lines business in New York since at least ELANY’s inception in 1989. By the end of 2021, Evanston Insurance was operating as a domestic surplus lines writer in Illinois and on a non-admitted basis across 49 states, the District of Columbia, Guam, Puerto Rico, and the U.S. Virgin Islands.;1977;Markel;N/A;N/A;;;
Westport Ins Corp;25247017;9448446;661809;25247017;9448446;661809;0;0;0;;19821;;;;;;
Obsidian Specialty Ins Co;24021313;12359934;387307;24021313;12359934;387307;0;0;0;;2020;Obsidian Insurance Holdings ;;;;;
Aspen Amer Ins Co;23937727;17829450;17527651;23834404;17662814;17374845;103323;166636;152806;;1990;Aspen US Holdings Inc;;;;;
United Specialty Ins Co;23392137;1233779;125134;18431682;128000;98419;4960455;1105779;26715;;;;;;;;
Allied World Ins Co;22498369;18940525;5876306;22409207;18812383;5757763;89162;128142;118543;"Fairfax Financial Holdings has agreed to acquire all outstanding registered ordinary shares of Allied World Assurance Company Holdings for approximately $4.9bn. Under the cash and share offer, Allied World shareholders would receive $54 per share, comprising $10 in cash and $44 in Fairfax subordinate voting shares. This represents an 18% premium to the closing price per Allied World share on 16 December. Fairfax can also choose to increase the total cash consideration payable to Allied World shareholders by up to $30 per share, taking the total cash per share to $40 if desired. The offer was unanimously supported by Allied World’s board. The merger will create a global leader in property and casualty insurance, reinsurance and investments, according to the company. It is subject to customary closing conditions, including approval by Allied World shareholders and regulatory approvals. Commenting on the merger, Prem Watsa, chairman and CEO of Fairfax, said: “Allied World is a high-quality company with an excellent long-term track record and an outstanding management team”. The acquisition will strengthen Fairfax’s worldwide operations and further diversify its group risk portfolio, the company said.
";2001;;2016;Fairfax ;;;
State Natl Ins Co Inc;22378938;6051459;1251701;21824577;5494554;1041335;554361;556905;210366;Markel Corporation has completed its acquisition of State National Companies, a provider of property and casualty insurance services. State National operates two core businesses, program and lender services. The acquisition was announced on 26 July 2017. Markel's Co-Chief Executive Officer, Richard R. Whitt, said the acquisition was exciting for many reasons, including the addition of a premier fronting platform through which insurance products can be offered throughout the US, as well as a recognised provider of collateral protection insurance to credit unions and regional banks. He also praised the people at State National and said their talent and integrity aligned with Markel's values. State National's Chairman and Chief Executive Officer, Terry Ledbetter, said the acquisition would enable the firm to offer clients unique, high-quality solutions with the support of Markel. State National will operate as an independent division of Markel. Markel Corporation is a diverse financial holding company that underwrites specialty insurance products.;1984;: State National Intermediate Holdings;2017;Markel Corporation;;;
National Fire & Marine Ins Co;22273878;12958874;4190662;22273878;12958874;4190662;0;0;0;;;;;;;;
Interstate Fire & Cas Co;22273811;12725089;1371980;855830;2465636;1326342;21417981;10259453;45638;;;;;;;;
Endurance Amer Ins Co;22183463;23969925;26271938;22183463;23969925;26271938;0;0;0;;;;;;;;
Hudson Excess Ins Co;21158941;79246130;34765794;21158941;79246130;34765794;0;0;0;Hudson Excess Insurance Company, was set up in May 2012 in Delaware as a subsidiary of the Odyssey Reinsurance Group (known as Odyssey Re). Fairfax Financial Holdings Limited, or Fairfax, ultimately has ownership of the company, retaining financial and operations control over Hudson Excess. The company secured eligibility to conduct surplus lines business in New York from April 29, 2013. As of December 31, 2021, Hudson Excess operates as a domestic surplus lines insurer in Delaware and runs on a non-admitted basis in forty-nine states, including the District of Columbia, Puerto Rico, and the U.S Virgin Islands.;2012;Odyssey Re (Fairfax);N/A;N/A;;;
National Union Fire Ins Co of Pittsb;20932475;0;0;20932475;0;0;0;0;0;;;;;;;;
Atlantic Specialty Ins Co;20056161;13106391;15160984;2055051;1448848;12792771;18001110;11657543;2368213;;;;;;;;
Lexington Ins Co;19935049;12257538;3289643;19935049;12257538;3289643;0;0;0;;;;;;;;
Safety Specialty Ins Co;19775576;13539234;4283665;19775576;13539234;4283665;0;0;0;;;;;;;;
Liberty Mut Ins Co;18548588;15255861;5346922;12790328;11500059;5118899;5758260;3755802;228023;;;;;;;;
Vantage Risk Specialty Ins Co;17972120;0;0;17972120;0;0;0;0;0;;;;;;;;
Chubb Custom Ins Co;17318905;11950855;9982556;0;0;0;17318905;11950855;9982556;;;;;;;;
Endurance Assur Corp;16396834;13741755;11288926;16396834;13741755;11288926;0;0;0;;;;;;;;
Great Amer Fidelity Ins Co;15772001;7506291;2058632;15772001;7506291;2058632;0;0;0;;;;;;;;
Freedom Specialty Ins Co;14855064;0;0;14855064;0;0;0;0;0;;;;;;;;
Privilege Underwriters Recp Exch;14676553;9288873;8174073;0;0;0;14676553;9288873;8174073;;;;;;;;
Texas Ins Co;14405856;5e+05;0;127500;0;0;14278356;5e+05;0;;;;;;;;
National Cas Co;14202202;676537;314892;14194609;673673;313781;7593;2864;1111;;;;;;;;
XL Specialty Ins Co;13981149;8420115;2659704;13981149;8420115;2659704;0;0;0;;;;;;;;
Markel Amer Ins Co;13968066;8971887;10752008;13968066;8971887;10752008;0;0;0;;;;;;;;
Hanover Ins Co;13110476;8078039;6612304;0;0;0;13110476;8078039;6612304;;;;;;;;
Sentinel Ins Co Ltd;12057335;11216607;13040139;0;0;0;12057335;11216607;13040139;;;;;;;;
Travelers Excess & Surplus Lines Co;11430284;5949083;2835248;10265044;5227289;1658445;1165240;721794;1176803;;;;;;;;
Federated Mut Ins Co;11428678;10774841;10264509;0;0;0;11428678;10774841;10264509;;;;;;;;
Homeland Ins Co of DE;10680649;7575531;84655;10605651;7502477;18102;74998;73054;66553;;;;;;;;
Federal Ins Co;10120286;22489277;25859638;0;15009;23200;10120286;22474268;25836438;;;;;;;;
Firemans Fund Ind Corp;10105185;0;0;6576316;0;0;3528869;0;0;;;;;;;;
Spinnaker Ins Co;9942620;219;0;9938120;0;0;4500;219;0;;;;;;;;
Transverse Specialty Ins Co;9774116;0;0;9774116;0;0;0;0;0;;;;;;;;
Factory Mut Ins Co;9731238;6274298;6236047;0;0;0;9731238;6274298;6236047;;;;;;;;
Great Amer Spirit Ins Co;9177685;7562917;6178532;4423338;3870355;4643710;4754347;3692562;1534822;;;;;;;;
Great Amer Ins Co;8800825;4828590;4088557;3528795;1756880;2299788;5272030;3071710;1788769;;;;;;;;
Hartford Steam Boil Inspec & Ins Co;8714014;4369492;2143760;8007469;3684368;1420952;706545;685124;722808;;;;;;;;
General Security Ind Co of AZ;8465563;2832839;323527;8447927;2828206;323527;17636;4633;0;;;;;;;;
Berkshire Hathaway Specialty Ins Co;8429207;12712351;5188085;8429207;12712351;5188085;0;0;0;;;;;;;;
Great Amer Security Ins Co;8280199;7048799;5164498;8280199;7048799;5164498;0;0;0;;;;;;;;
West Bend Mut Ins Co;7880419;7403121;6858664;0;0;0;7880419;7403121;6858664;;;;;;;;
Berkley Ins Co;7780244;9612620;8286088;7775384;9607989;8283256;4860;4631;2832;;;;;;;;
Stratford Ins Co;7717176;6153017;2770856;7717176;6153017;2770856;0;0;0;;;;;;;;
Nationwide Gen Ins Co;7476269;3548055;1447238;0;0;0;7476269;3548055;1447238;;;;;;;;
Employers Mut Cas Co;7388875;6543160;6011776;7388875;6543160;6011776;0;0;0;;;;;;;;
Erie Ins Co;7357157;2070849;518370;0;0;0;7357157;2070849;518370;;;;;;;;
Everest Ind Ins Co;7183719;5864622;1250046;7183719;5864622;1250046;0;0;0;;;;;;;;
AXIS Reins Co;6983291;6970071;0;6983291;6970071;0;0;0;0;;;;;;;;
US Specialty Ins Co;6864278;20520897;17086390;6864278;5231263;2077801;0;15289634;15008589;;;;;;;;
Federated Rural Electric Ins Exch;5952325;4932133;4170843;0;0;0;5952325;4932133;4170843;;;;;;;;
Ohio Security Ins Co;5454940;11147338;10051562;0;0;0;5454940;11147338;10051562;;;;;;;;
Continental Ins Co Of NJ;5442326;4195612;3405551;697131;489609;312092;4745195;3706003;3093459;;;;;;;;
Scottsdale Surplus Lines Ins Co;5425034;33143;26996;5424784;33143;26996;250;0;0;;;;;;;;
American Cas Co Of Reading PA;5321480;5204889;4933002;0;0;0;5321480;5204889;4933002;;;;;;;;
Acuity A Mut Ins Co;5200111;4793385;3336555;0;0;0;5200111;4793385;3336555;;;;;;;;
Navigators Specialty Ins Co;5102755;4634496;4102097;5102755;4634496;4102097;0;0;0;;;;;;;;
Truck Ins Exch;5089441;5015577;4530260;0;0;0;5089441;5015577;4530260;;;;;;;;
Tokio Marine Specialty Ins Co;4942213;3441383;1775826;4881708;717905;876689;60505;2723478;899137;;;;;;;;
Endurance Risk Solutions Assur Co;4911216;7858671;11519425;4911216;7858671;11519425;0;0;0;;;;;;;;
Brotherhood Mut Ins Co;4756821;4359032;4148072;0;0;0;4756821;4359032;4148072;;;;;;;;
Superior Specialty Ins Co;4390687;0;0;1501158;0;0;2889529;0;0;;;;;;;;
Medical Protective Co;4360329;4760821;3705454;0;0;0;4360329;4760821;3705454;;;;;;;;
MMIC Ins Inc;4316415;4832406;4897902;0;0;0;4316415;4832406;4897902;;;;;;;;
Westchester Fire Ins Co;4297951;3752052;3859269;0;0;0;4297951;3752052;3859269;;;;;;;;
Church Mut Ins Co S I;4278019;3924340;3578849;17217;15953;12836;4260802;3908387;3566013;;;;;;;;
Copic Ins Co;4055075;2623768;1901308;0;0;0;4055075;2623768;1901308;;;;;;;;
Capitol Specialty Ins Corp;3755868;5544707;6904972;250816;300252;780031;3505052;5244455;6124941;;;;;;;;
Central Mut Ins Co;3748412;3635510;2970916;0;0;0;3748412;3635510;2970916;;;;;;;;
Great Amer Assur Co;3745712;3073592;2266794;271672;933439;840062;3474040;2140153;1426732;;;;;;;;
Travelers Cas Ins Co Of Amer;3492695;3783887;4118774;0;0;0;3492695;3783887;4118774;;;;;;;;
Allstate Ins Co;3489188;3943267;1005257;0;0;0;3489188;3943267;1005257;;;;;;;;
Citizens Ins Co Of Amer;3446195;3886753;4113779;0;0;0;3446195;3886753;4113779;;;;;;;;
Erie Ins Exch;3420880;4117326;4654869;0;0;0;3420880;4117326;4654869;;;;;;;;
Secura Ins Co;3358953;1972252;0;0;0;0;3358953;1972252;0;;;;;;;;
Utica First Ins Co;3334996;3552264;3414893;0;0;0;3334996;3552264;3414893;;;;;;;;
Farmers Ins Exch;3245121;3478040;3343020;0;0;0;3245121;3478040;3343020;;;;;;;;
Owners Ins Co;3184433;2539725;1944497;0;0;0;3184433;2539725;1944497;;;;;;;;
Liberty Ins Underwriters Inc;3114307;6714749;162272;3114307;6714749;162272;0;0;0;;;;;;;;
Western World Ins Co;2968202;2122831;4583119;2968202;2122831;4583119;0;0;0;;;;;;;;
Indiana Farmers Mut Ins Co;2938209;3086857;1363302;0;0;0;2938209;3086857;1363302;;;;;;;;
National Liab & Fire Ins Co;2899321;1885110;317086;2899321;1885110;317086;0;0;0;;;;;;;;
Mount Vernon Specialty Ins Co;2889091;910282;209550;0;0;0;2889091;910282;209550;;;;;;;;
State Farm Fire & Cas Co;2760427;2491544;2132248;0;0;0;2760427;2491544;2132248;;;;;;;;
Mid Century Ins Co;2704388;2892645;2854880;0;0;0;2704388;2892645;2854880;;;;;;;;
Amguard Ins Co;2653992;1274210;293836;0;0;0;2653992;1274210;293836;;;;;;;;
Massachusetts Bay Ins Co;2647978;2860108;2989687;0;0;0;2647978;2860108;2989687;;;;;;;;
Frankenmuth Mut Ins Co;2585874;2123373;1703214;0;0;0;2585874;2123373;1703214;;;;;;;;
Great Northern Ins Co;2529603;4493556;6599289;0;0;0;2529603;4493556;6599289;;;;;;;;
Professional Security Ins Co;2521150;2249970;2077319;986305;914467;871057;1534845;1335503;1206262;;;;;;;;
Technology Ins Co Inc;2471877;0;0;2471877;0;0;0;0;0;;;;;;;;
Mount Vernon Fire Ins Co;2425917;2074716;1779683;-3815;829428;1145832;2429732;1245288;633851;;;;;;;;
The Cincinnati Ind Co;2393805;2305172;1975045;0;0;0;2393805;2305172;1975045;;;;;;;;
Norcal Ins Co;2386225;2303163;0;0;0;0;2386225;2303163;0;;;;;;;;
Proselect Ins Co;2362418;2481208;2400080;0;0;0;2362418;2481208;2400080;;;;;;;;
St Paul Fire & Marine Ins Co;2308661;1745132;1685875;0;0;0;2308661;1745132;1685875;;;;;;;;
Grinnell Mut Reins Co;2305660;2257475;2140100;0;0;0;2305660;2257475;2140100;;;;;;;;
Accredited Surety & Cas Co Inc;2300528;1112568;0;0;0;0;2300528;1112568;0;;;;;;;;
Main St Amer Assur Co;2279802;2331618;2354492;0;0;0;2279802;2331618;2354492;;;;;;;;
Ace Fire Underwriters Ins Co;2256497;1195600;1318948;0;0;0;2256497;1195600;1318948;;;;;;;;
Travelers Ind Co Of CT;2240301;1917680;1625513;0;0;0;2240301;1917680;1625513;;;;;;;;
Ace Prop & Cas Ins Co;2206610;0;0;0;0;0;2206610;0;0;;;;;;;;
United Fire & Cas Co;2118449;2284079;2697926;0;0;0;2118449;2284079;2697926;;;;;;;;
Camico Mut Ins Co;2094813;2068729;1913932;0;0;0;2094813;2068729;1913932;;;;;;;;
Pennsylvania Natl Mut Cas Ins Co;1917025;1958652;2042332;0;0;0;1917025;1958652;2042332;;;;;;;;
Chubb Natl Ins Co;1910277;1528536;992420;0;0;0;1910277;1528536;992420;;;;;;;;
Nationwide Assur Co;1908806;701857;12881;0;0;0;1908806;701857;12881;;;;;;;;
Berkshire Hathaway Direct Ins Co;1901967;0;312612;0;0;0;1901967;0;312612;;;;;;;;
Sentry Select Ins Co;1874108;1770869;1704665;0;0;0;1874108;1770869;1704665;;;;;;;;
New York Marine & Gen Ins Co;1835283;4974676;4226840;0;0;0;1835283;4974676;4226840;;;;;;;;
Nautilus Ins Co;1781924;1374867;1166263;714;522;0;1781210;1374345;1166263;;;;;;;;
ISMIE Mut Ins Co;1760501;1730981;1936607;0;0;0;1760501;1730981;1936607;;;;;;;;
The Cincinnati Cas Co;1753725;1713306;1731948;0;0;0;1753725;1713306;1731948;;;;;;;;
State Automobile Mut Ins Co;1683275;1482659;1861898;0;0;0;1683275;1482659;1861898;;;;;;;;
Selective Ins Co Of Amer;1669414;1380401;1154716;0;0;0;1669414;1380401;1154716;;;;;;;;
Hartford Cas Ins Co;1655596;2232118;2914600;0;0;0;1655596;2232118;2914600;;;;;;;;
Pharmacists Mut Ins Co;1652138;1460612;1398372;0;0;0;1652138;1460612;1398372;;;;;;;;
Attorneys Liab Assur Society Ltd;1643545;1618902;1522444;0;0;0;1643545;1618902;1522444;;;;;;;;
Hartford Fire Ins Co;1628596;2428874;3057445;0;0;0;1628596;2428874;3057445;;;;;;;;
Grange Ins Co;1539760;1627431;1637046;0;0;0;1539760;1627431;1637046;;;;;;;;
Society Ins a Mut Co;1519226;1191954;1042280;1519226;1191954;1042280;0;0;0;;;;;;;;
NASW RRG Inc;1505880;1256448;954605;1505880;1256448;954605;0;0;0;;;;;;;;
Selective Ins Co Of SC;1468928;1261506;1397205;0;0;0;1468928;1261506;1397205;;;;;;;;
Greater NY Mut Ins Co;1465213;1243876;958249;0;0;0;1465213;1243876;958249;;;;;;;;
Oms Natl Ins Co Rrg;1460770;1023920;0;0;0;0;1460770;1023920;0;;;;;;;;
Auto Owners Ins Co;1435470;1131419;841888;0;0;0;1435470;1131419;841888;;;;;;;;
Amco Ins Co;1413157;1886374;1322819;0;0;0;1413157;1886374;1322819;;;;;;;;
Valley Forge Ins Co;1387925;1501430;1562822;0;0;0;1387925;1501430;1562822;;;;;;;;
Pacific Ins Co Ltd;1378419;1582131;874385;1378419;1582131;566022;0;0;308363;;;;;;;;
Insurance Co Of Greater NY;1375097;1063714;650979;0;0;0;1375097;1063714;650979;;;;;;;;
Safety Natl Cas Corp;1369047;1114737;696280;1369047;1114737;696280;0;0;0;;;;;;;;
Allmerica Fin Benefit Ins Co;1350543;355785;0;0;0;0;1350543;355785;0;;;;;;;;
Travelers Ind Co;1339849;1147976;1566823;0;0;0;1339849;1147976;1566823;;;;;;;;
Navigators Ins Co;1332012;1139898;1009133;1332012;1139898;1009133;0;0;0;;;;;;;;
Tri State Ins Co Of MN;1331382;1246612;1202708;0;0;0;1331382;1246612;1202708;;;;;;;;
Federated Serv Ins Co;1323289;1165685;784989;0;0;0;1323289;1165685;784989;;;;;;;;
Beazley Amer Ins Co Inc;1312948;951788;0;0;0;0;1312948;951788;0;;;;;;;;
State Auto Prop & Cas Ins Co;1300373;1650220;2245673;0;0;0;1300373;1650220;2245673;;;;;;;;
Rural Trust Ins Co;1296275;711654;0;580316;377741;0;715959;333913;0;;;;;;;;
Mutual Of Enumclaw Ins Co;1289399;1377908;1374471;0;0;0;1289399;1377908;1374471;;;;;;;;
Republic Franklin Ins Co;1271831;1154764;963463;0;0;0;1271831;1154764;963463;;;;;;;;
American Hallmark Ins Co Of TX;1269616;1338306;1432093;0;0;0;1269616;1338306;1432093;;;;;;;;
Brethren Mut Ins Co;1266694;1259134;1260275;0;0;0;1266694;1259134;1260275;;;;;;;;
Utica Mut Ins Co;1217531;1094882;993170;0;0;0;1217531;1094882;993170;;;;;;;;
Sentry Ins Co;1217157;1171963;0;0;0;0;1217157;1171963;0;;;;;;;;
Nationwide Mut Ins Co;1215848;1011016;1295866;0;0;0;1215848;1011016;1295866;;;;;;;;
Motorists Commercial Mut Ins Co;1161776;1304720;1383435;0;0;0;1161776;1304720;1383435;;;;;;;;
Obsidian Ins Co;1130747;2757778;4776;1130747;2757778;4776;0;0;0;;;;;;;;
North Star Mut Ins Co;1123155;1027416;951778;0;0;0;1123155;1027416;951778;;;;;;;;
Westfield Ins Co;1100733;1376758;1363809;0;0;0;1100733;1376758;1363809;;;;;;;;
Peleus Ins Co;1077942;1522308;5437077;1072810;10333;308091;5132;1511975;5128986;;;;;;;;
Fidelity & Guar Ins Co;1067758;897453;297497;0;0;0;1067758;897453;297497;;;;;;;;
MT Hawley Ins Co;1061047;1172653;576508;0;424750;570701;1061047;747903;5807;;;;;;;;
Districts Mut Ins & Risk Mgmt Serv;1057429;721191;490421;1057429;721191;490421;0;0;0;;;;;;;;
ALPS Prop & Cas  Ins  Co;1043356;931278;787274;1043356;0;0;0;931278;787274;;;;;;;;
Federated Reserve Ins Co;1043309;868525;658246;0;0;0;1043309;868525;658246;;;;;;;;
New York Municipal Ins Recip;971215;641486;356252;0;0;0;971215;641486;356252;;;;;;;;
Merrimack Mut Fire Ins Co;970179;963469;940737;0;0;0;970179;963469;940737;;;;;;;;
Selective Ins Co Of The Southeast;943935;794641;826197;0;0;0;943935;794641;826197;;;;;;;;
Admiral Ind Co;919451;774344;702666;0;0;0;919451;774344;702666;;;;;;;;
Houston Specialty Ins Co;916983;67936;218398;0;0;0;916983;67936;218398;;;;;;;;
Radnor Specialty Ins Co;916456;398434;98199;0;0;0;916456;398434;98199;;;;;;;;
Pacific Ind Co;916108;891294;774008;0;0;0;916108;891294;774008;;;;;;;;
Dentists Ins Co;913859;956468;940340;913859;956468;940340;0;0;0;;;;;;;;
Pennsylvania Lumbermens Mut Ins;913322;740267;698944;0;0;0;913322;740267;698944;;;;;;;;
GuideOne Ins Co;912913;580497;0;0;0;0;912913;580497;0;;;;;;;;
Hanover Amer Ins Co;908165;1034898;1141679;0;0;0;908165;1034898;1141679;;;;;;;;
Midwest Family Mut Ins Co;906942;918634;963411;0;0;0;906942;918634;963411;;;;;;;;
Universal Ins Co;905458;163301;0;0;0;0;905458;163301;0;;;;;;;;
Allied Ins Co of Amer;904510;2321655;2329567;0;0;0;904510;2321655;2329567;;;;;;;;
UMIA Ins Inc;887788;1050977;911300;0;0;0;887788;1050977;911300;;;;;;;;
Main Street Amer Protection Ins Co;884650;809625;802698;0;0;0;884650;809625;802698;;;;;;;;
American Alt Ins Corp;883461;787579;272061;0;0;0;883461;787579;272061;;;;;;;;
Penn Natl Security Ins Co;878271;882902;848466;0;0;0;878271;882902;848466;;;;;;;;
Nationwide Ins Co Of FL;873956;410875;13696;0;0;0;873956;410875;13696;;;;;;;;
Jewelers Mut Ins Co S I;859402;840583;854208;0;0;0;859402;840583;854208;;;;;;;;
Merchants Mut Ins Co;856721;948989;972643;0;0;0;856721;948989;972643;;;;;;;;
Norfolk & Dedham Mut Fire Ins Co;846121;756387;495203;0;0;0;846121;756387;495203;;;;;;;;
Hastings Mut Ins Co;832310;531691;379565;0;0;0;832310;531691;379565;;;;;;;;
Oregon Mut Ins Co;818613;808536;750428;0;0;0;818613;808536;750428;;;;;;;;
Vault Recip Exch;817992;522476;144723;0;0;0;817992;522476;144723;;;;;;;;
Pacific Employers Ins Co;817006;0;0;0;0;0;817006;0;0;;;;;;;;
Graphic Arts Mut Ins Co;801395;658164;573289;0;0;0;801395;658164;573289;;;;;;;;
United States Liab Ins Co;799471;689685;619159;-420;75811;109559;799891;613874;509600;;;;;;;;
Preferred Mut Ins Co;795812;812543;861942;0;0;0;795812;812543;861942;;;;;;;;
Contractors Bonding & Ins Co;793765;546368;351528;0;0;1050;793765;546368;350478;;;;;;;;
Farm Bureau Prop & Cas Ins Co;790864;741423;709190;0;0;0;790864;741423;709190;;;;;;;;
Western Agric Ins Co;759053;713821;681972;0;0;0;759053;713821;681972;;;;;;;;
Home Owners Ins Co;754080;555012;404069;0;0;0;754080;555012;404069;;;;;;;;
NAMIC Ins Co Inc;736429;681573;605693;563301;510245;403351;173128;171328;202342;;;;;;;;
FCCI Ins Co;734906;764369;749419;0;0;0;734906;764369;749419;;;;;;;;
Great Amer Ins Co of NY;732424;874804;913974;0;0;0;732424;874804;913974;;;;;;;;
United Ohio Ins Co;713515;709634;714179;0;0;0;713515;709634;714179;;;;;;;;
Western Natl Mut Ins Co;713391;681401;669219;0;0;0;713391;681401;669219;;;;;;;;
ProAssurance Ind Co Inc;710786;615027;568010;0;0;0;710786;615027;568010;;;;;;;;
Western Reserve Mut Cas Co;709439;673254;603696;0;0;0;709439;673254;603696;;;;;;;;
National Amer Ins Co;705409;620208;460414;0;0;0;705409;620208;460414;;;;;;;;
Benchmark Ins Co;701767;29487659;447707;-2367;28925955;152924;704134;561704;294783;;;;;;;;
ProAssurance Cas Co;694834;609935;603354;0;0;0;694834;609935;603354;;;;;;;;
Harford Mut Ins Co;687754;539504;365550;73315;50691;55085;614439;488813;310465;;;;;;;;
Physicians Ins A Mut Co;684531;602973;278285;680252;0;0;4279;602973;278285;;;;;;;;
Chubb Lloyds Ins Co Of TX;684018;575554;436164;0;0;0;684018;575554;436164;;;;;;;;
Quincy Mut Fire Ins Co;665941;644790;614527;0;0;0;665941;644790;614527;;;;;;;;
Hartford Accident & Ind Co;661338;982452;939489;309348;597527;0;351990;384925;939489;;;;;;;;
Affiliated Fm Ins Co;646801;512781;498268;0;0;0;646801;512781;498268;;;;;;;;
Union Ins Co;627072;665056;714375;0;0;0;627072;665056;714375;;;;;;;;
Key Risk Ins Co;626163;1424212;0;626163;1424212;0;0;0;0;;;;;;;;
All Amer Ins Co;616386;580908;496607;0;0;0;616386;580908;496607;;;;;;;;
Atlantic States Ins Co;609107;635191;661243;0;0;0;609107;635191;661243;;;;;;;;
Michigan Millers Mut Ins Co;608862;576419;549310;0;0;0;608862;576419;549310;;;;;;;;
Acadia Ins Co;596391;640065;683427;0;0;0;596391;640065;683427;;;;;;;;
Integrity Ins Co;586760;618886;614706;0;0;0;586760;618886;614706;;;;;;;;
Depositors Ins Co;563603;797268;605967;0;0;0;563603;797268;605967;;;;;;;;
Mennonite Mut Ins Co;561377;524901;358622;0;0;0;561377;524901;358622;;;;;;;;
Chubb Ins Co Of NJ;550074;932273;912855;0;0;0;550074;932273;912855;;;;;;;;
Kansas Medical Mut Ins Co;547949;345547;334136;0;0;0;547949;345547;334136;;;;;;;;
Selective Way Ins Co;547792;483964;510428;0;0;0;547792;483964;510428;;;;;;;;
ProAssurance Ins Co of Amer;537843;237200;211224;0;0;0;537843;237200;211224;;;;;;;;
Medical Professional Mut Ins Co;537724;626839;664169;0;0;0;537724;626839;664169;;;;;;;;
Strathmore Ins Co;531898;462097;346727;0;0;0;531898;462097;346727;;;;;;;;
Republic Vanguard Ins Co;531205;158250;0;531205;158250;0;0;0;0;;;;;;;;
Monroe Guar Ins Co;529032;500693;459425;0;0;0;529032;500693;459425;;;;;;;;
First Fire & Cas Ins Of HI Inc;527063;518864;552349;0;0;0;527063;518864;552349;;;;;;;;
Community Blood Cntr Exch RRG;517491;466499;381779;0;0;0;517491;466499;381779;;;;;;;;
Continental Western Ins Co;513741;591879;701539;0;0;0;513741;591879;701539;;;;;;;;
Lightning Rod Mut Ins Co;507747;512169;494282;0;0;0;507747;512169;494282;;;;;;;;
Illinois Natl Ins Co;505085;518159;6632712;505085;518159;6632712;0;0;0;;;;;;;;
State Farm Gen Ins Co;503870;425228;338842;0;0;0;503870;425228;338842;;;;;;;;
Donegal Mut Ins Co;503746;551990;572577;0;0;0;503746;551990;572577;;;;;;;;
Farmers Alliance Mut Ins Co;500186;449416;419505;0;0;0;500186;449416;419505;;;;;;;;
Rural Mut Ins Co;499433;482896;465700;0;0;0;499433;482896;465700;;;;;;;;
Midvale Ind Co;490865;312408;17165;0;0;0;490865;312408;17165;;;;;;;;
Umialik Ins Co;489225;452986;412521;0;0;0;489225;452986;412521;;;;;;;;
Coverys Specialty Ins Co;486849;437840;351442;0;0;0;486849;437840;351442;;;;;;;;
MSIG Specialty Ins USA Inc;485000;340336;251523;485000;340336;251523;0;0;0;;;;;;;;
Continental Ins Co;483487;561691;460859;248932;4990;41580;234555;556701;419279;;;;;;;;
Blackboard Ins Co;476039;1769412;1927645;0;0;0;476039;1769412;1927645;;;;;;;;
Us Underwriters Ins Co;474711;357350;296303;-1806;120492;161812;476517;236858;134491;;;;;;;;
Medical Ins Exch Of CA;469569;475139;476426;0;0;0;469569;475139;476426;;;;;;;;
Berkley Specialty Ins Co;466273;319790;157545;199650;100461;4023;266623;219329;153522;;;;;;;;
Wadena Ins Co;462957;376325;308323;0;0;0;462957;376325;308323;;;;;;;;
General Ins Co Of Amer;452013;394272;465534;0;0;0;452013;394272;465534;;;;;;;;
Farm Credit System Assn Captive Ins;450239;0;0;450239;0;0;0;0;0;;;;;;;;
Princeton Ins Co;449958;567421;535755;0;0;0;449958;567421;535755;;;;;;;;
Pekin Ins Co;449370;346490;197132;0;0;0;449370;346490;197132;;;;;;;;
Star Ins Co;441017;452545;413240;0;0;0;441017;452545;413240;;;;;;;;
Accelerant Specialty Ins Co;437413;202616;0;0;0;0;437413;202616;0;;;;;;;;
The Hanover Cas Co;431973;512689;516346;0;0;0;431973;512689;516346;;;;;;;;
Addison Ins Co;431224;484567;565748;0;0;0;431224;484567;565748;;;;;;;;
National Trust Ins Co;428654;547757;625561;0;0;0;428654;547757;625561;;;;;;;;
James River Ins Co;425986;337654;282588;0;0;0;425986;337654;282588;;;;;;;;
Old Guard Ins Co;422877;127245;29126;0;0;0;422877;127245;29126;;;;;;;;
Zurich Amer Ins Co Of IL;418517;263757;186358;398735;261246;179191;19782;2511;7167;;;;;;;;
Nationwide Agribusiness Ins Co;418003;160284;220643;0;0;0;418003;160284;220643;;;;;;;;
Vigilant Ins Co;402824;315002;224216;0;0;0;402824;315002;224216;;;;;;;;
Travelers Ind Co Of Amer;398815;483418;642920;0;0;0;398815;483418;642920;;;;;;;;
Selective Fire & Cas Ins Co;396867;242178;187000;0;0;0;396867;242178;187000;;;;;;;;
Utica Natl Ins Co of OH;396320;318981;322590;0;0;0;396320;318981;322590;;;;;;;;
MMIC RRG Inc;395024;52881;0;0;0;0;395024;52881;0;;;;;;;;
Executive Risk Ind Inc;394984;367935;573294;0;0;19021;394984;367935;554273;;;;;;;;
Mountain W Farm Bureau Mut Ins Co;393715;0;0;0;0;0;393715;0;0;;;;;;;;
Property Owners Ins Co;383485;325595;0;0;0;0;383485;325595;0;;;;;;;;
Alaska Natl Ins Co;382457;388349;280897;0;0;0;382457;388349;280897;;;;;;;;
Selective Ins Co of New England;377659;237343;142584;0;0;0;377659;237343;142584;;;;;;;;
Illinois Cas Co;376691;382118;358389;0;0;0;376691;382118;358389;;;;;;;;
United Farm Family Mut Ins Co;376312;345210;334486;0;0;0;376312;345210;334486;;;;;;;;
Selective Cas Ins Co;372335;221625;150369;0;0;0;372335;221625;150369;;;;;;;;
Financial Pacific Ins Co;369103;322242;378395;0;0;0;369103;322242;378395;;;;;;;;
Restoration RRG Inc;362498;342287;282393;362498;342287;282393;0;0;0;;;;;;;;
Firstline Ins Co;358784;364905;514406;57855;56289;55244;300929;308616;459162;;;;;;;;
Rockford Mut Ins Co;347502;331151;314814;0;0;0;347502;331151;314814;;;;;;;;
Harleysville Ins Co;341450;314301;251120;0;0;0;341450;314301;251120;;;;;;;;
Transportation Ins Co;338247;393816;282212;0;0;0;338247;393816;282212;;;;;;;;
Dorchester Mut Ins Co;333542;311700;0;0;0;0;333542;311700;0;;;;;;;;
Goodville Mut Cas Co;331146;327799;331535;0;0;0;331146;327799;331535;;;;;;;;
Badger Mut Ins Co;327008;327656;308327;0;0;0;327008;327656;308327;;;;;;;;
Utica Natl Assur Co;325137;264644;157250;0;0;0;325137;264644;157250;;;;;;;;
Professional Solutions Ins Co;321356;369843;432773;0;0;0;321356;369843;432773;;;;;;;;
Secura Supreme Ins Co;320778;159809;103724;0;0;0;320778;159809;103724;;;;;;;;
Capitol Ind Corp;320132;524188;423317;0;-16;19963;320132;524204;403354;;;;;;;;
Country Mut Ins Co;317690;254001;186590;0;0;0;317690;254001;186590;;;;;;;;
Germantown Mut Ins Co;316468;321025;331036;0;0;0;316468;321025;331036;;;;;;;;
The Cincinnati Specialty Underwriter;307997;255115;0;0;0;0;307997;255115;0;;;;;;;;
Charter Oak Fire Ins Co;305634;292710;260981;0;0;0;305634;292710;260981;;;;;;;;
United Fire LLoyds;302933;349529;381405;0;0;0;302933;349529;381405;;;;;;;;
BITCO Gen Ins Corp;299438;72835;0;0;0;0;299438;72835;0;;;;;;;;
Pioneer State Mut Ins Co;293841;279546;236638;0;0;0;293841;279546;236638;;;;;;;;
Nationwide Affinity Co of Amer;290930;98114;324;0;0;0;290930;98114;324;;;;;;;;
Grain Dealers Mut Ins Co;281334;275090;259905;0;0;0;281334;275090;259905;;;;;;;;
MedPro RRG RRG;279037;809367;233649;0;0;0;279037;809367;233649;;;;;;;;
Pace RRG Inc;276497;211011;44500;276497;211011;44500;0;0;0;;;;;;;;
Phoenix Ins Co;273349;326977;386863;0;0;0;273349;326977;386863;;;;;;;;
Middlesex Ins Co;270737;232269;213702;0;0;0;270737;232269;213702;;;;;;;;
Cambridge Mut Fire Ins Co;267949;254605;214118;0;0;0;267949;254605;214118;;;;;;;;
Michigan Ins Co;267177;247099;212149;0;0;0;267177;247099;212149;;;;;;;;
Berkley Regional Ins Co;266722;320586;168137;8014;18940;0;258708;301646;168137;;;;;;;;
Westfield Natl Ins Co;265100;321003;329723;0;0;0;265100;321003;329723;;;;;;;;
Great Amer E&S Ins Co;262079;2233558;2289919;252187;2136854;2174969;9892;96704;114950;;;;;;;;
United Financial Cas Co;261278;111584;24903;0;0;0;261278;111584;24903;;;;;;;;
Allied Prop & Cas Ins Co;260147;385113;280053;0;0;0;260147;385113;280053;;;;;;;;
State Farm Lloyds;258221;224343;192908;0;0;0;258221;224343;192908;;;;;;;;
RLI Ins Co;258076;10651555;13395358;52980;10461132;13263049;205096;190423;132309;;;;;;;;
Firemans Fund Ins Co;257743;656750;657256;0;0;0;257743;656750;657256;;;;;;;;
National Fire Ins Co Of Hartford;257560;448081;513433;0;0;0;257560;448081;513433;;;;;;;;
Chubb Ind Ins Co;251139;231369;130369;0;0;0;251139;231369;130369;;;;;;;;
Copic RRG;249926;80834;53800;0;0;0;249926;80834;53800;;;;;;;;
Preferred Professional Ins Co;247485;0;0;0;0;0;247485;0;0;;;;;;;;
Gotham Ins Co;241083;621940;528445;0;0;0;241083;621940;528445;;;;;;;;
Florists Mut Ins Co;240517;234702;238025;0;0;0;240517;234702;238025;;;;;;;;
Professionals Advocate Ins Co;238828;215656;192142;238828;215656;192142;0;0;0;;;;;;;;
Celina Mut Ins Co;232708;205068;186329;0;0;0;232708;205068;186329;;;;;;;;
Vantage Risk Assur Co;228964;0;0;0;0;0;228964;0;0;;;;;;;;
Great Amer Alliance Ins Co;225227;234120;362764;0;0;94477;225227;234120;268287;;;;;;;;
West Amer Ins Co;224656;298071;293077;0;0;0;224656;298071;293077;;;;;;;;
Merchants Preferred Ins Co;222701;126195;91100;0;0;0;222701;126195;91100;;;;;;;;
NGM Ins Co;217037;196027;172812;0;0;0;217037;196027;172812;;;;;;;;
Arkansas Mut Ins Co;207592;191119;241739;0;0;0;207592;191119;241739;;;;;;;;
Berkley Natl Ins Co;205831;262683;217445;0;0;0;205831;262683;217445;;;;;;;;
Triangle Ins Co Inc;203305;162283;123803;0;0;0;203305;162283;123803;;;;;;;;
Fitchburg Mut Ins Co;203076;173650;174616;0;0;0;203076;173650;174616;;;;;;;;
American Natl Prop & Cas Co;200519;145704;110468;0;0;0;200519;145704;110468;;;;;;;;
Nationwide Ins Co Of Amer;199960;210139;170813;0;0;0;199960;210139;170813;;;;;;;;
Farmers Ins Co of Flemington;199196;140438;0;0;0;0;199196;140438;0;;;;;;;;
Utica Natl Ins Co Of TX;192289;179280;149814;0;0;0;192289;179280;149814;;;;;;;;
American Fire & Cas Co;190911;408887;377995;0;0;0;190911;408887;377995;;;;;;;;
Guideone Elite Ins Co;186721;143347;86870;0;0;0;186721;143347;86870;;;;;;;;
Bay State Ins Co;185401;163412;141870;0;0;0;185401;163412;141870;;;;;;;;
Harleysville Worcester Ins Co;184497;226488;235514;0;0;0;184497;226488;235514;;;;;;;;
Harleysville Preferred Ins Co;183925;229801;213439;0;0;0;183925;229801;213439;;;;;;;;
DTRIC Ins Underwriters Ltd;183108;42666;52868;0;0;0;183108;42666;52868;;;;;;;;
Firemens Ins Co Of Washington DC;183005;231222;237920;0;0;0;183005;231222;237920;;;;;;;;
Mitsui Sumitomo Ins Co of Amer;182694;172021;82891;0;0;18000;182694;172021;64891;;;;;;;;
Safepoint Ins Co;182295;135598;77775;0;0;0;182295;135598;77775;;;;;;;;
Plico Inc;179765;175506;176392;0;0;0;179765;175506;176392;;;;;;;;
Hartford Ins Co Of The Midwest;178407;253427;335403;0;0;0;178407;253427;335403;;;;;;;;
GuideOne Specialty Ins Co;176408;110580;0;0;0;0;176408;110580;0;;;;;;;;
Southern Ins Co Of VA;176002;194307;237511;0;0;0;176002;194307;237511;;;;;;;;
Texas Hospital Ins Exch;175698;140353;76965;0;0;0;175698;140353;76965;;;;;;;;
Penn Star Ins Co;173451;185307;178231;0;0;0;173451;185307;178231;;;;;;;;
Erie Ins Prop & Cas Co;170876;201045;222396;0;0;0;170876;201045;222396;;;;;;;;
Vault E&S Ins Co;170850;81534;12830;0;0;0;170850;81534;12830;;;;;;;;
Millville Mut Ins Co;168421;190220;0;0;0;0;168421;190220;0;;;;;;;;
California Gen Underwriters Ins Co;167379;101215;0;0;0;0;167379;101215;0;;;;;;;;
Hartford Lloyds Ins Co;165729;243187;321126;0;0;0;165729;243187;321126;;;;;;;;
Western Natl Assur Co;164863;145506;114782;0;0;0;164863;145506;114782;;;;;;;;
First Ins Co Of HI Ltd;164026;120872;124981;0;0;0;164026;120872;124981;;;;;;;;
Co Operative Ins Cos;161948;152848;138543;0;0;0;161948;152848;138543;;;;;;;;
Michigan Professional Ins Exch;157436;134480;129928;0;0;0;157436;134480;129928;;;;;;;;
Gemini Ins Co;157237;182547;194003;128143;155869;170647;29094;26678;23356;;;;;;;;
Mutual Benefit Ins Co;153224;139850;122164;0;0;0;153224;139850;122164;;;;;;;;
Westfield Champion Ins Co;150326;54427;6064;0;0;0;150326;54427;6064;;;;;;;;
Coverys RRG Inc;149558;206140;174472;0;0;0;149558;206140;174472;;;;;;;;
IMT Ins Co;149021;127742;118573;0;0;0;149021;127742;118573;;;;;;;;
First Security Ins Of HI Inc;146936;20098;20643;0;0;0;146936;20098;20643;;;;;;;;
Pioneer Specialty Ins Co;144813;132813;123086;0;0;0;144813;132813;123086;;;;;;;;
Penn Amer Ins Co;141889;134781;117159;0;0;0;141889;134781;117159;;;;;;;;
Southwest Marine & Gen Ins Co;138804;477647;405843;0;0;0;138804;477647;405843;;;;;;;;
Frederick Mut Ins Co;136521;102922;0;0;0;0;136521;102922;0;;;;;;;;
Ohio Cas Ins Co;134696;184623;164327;0;0;0;134696;184623;164327;;;;;;;;
Grange Ins Co of MI;134407;156007;162432;0;0;0;134407;156007;162432;;;;;;;;
Brierfield Ins Co;133860;168021;183885;0;0;0;133860;168021;183885;;;;;;;;
Attorneys Ins Mut of the South Inc R;133055;127154;110453;0;0;0;133055;127154;110453;;;;;;;;
Austin Mut Ins Co;132327;118874;101400;0;0;0;132327;118874;101400;;;;;;;;
CM Select Ins Co;131607;115752;47693;0;0;0;131607;115752;47693;;;;;;;;
Old Republic Ins Co;130021;85021;45023;130021;85021;45023;0;0;0;;;;;;;;
American Select Ins Co;126085;152307;109884;0;0;0;126085;152307;109884;;;;;;;;
Virginia Farm Bureau Town & Cntry;117967;0;0;0;0;0;117967;0;0;;;;;;;;
Underwriters At Lloyds London;117800;14616288;12717083;117800;14616288;12717083;0;0;0;;;;;;;;
Safeco Ins Co Of Amer;117350;0;2;0;0;0;117350;0;2;;;;;;;;
American Prop Ins Co;116701;125884;129991;0;0;0;116701;125884;129991;;;;;;;;
Voyager Ind Ins Co;110506;146989;29684;110506;146989;29684;0;0;0;;;;;;;;
Spring Valley Mut Ins Co;109585;110088;109320;0;0;0;109585;110088;109320;;;;;;;;
Harleysville Ins Co Of NJ;109531;147168;126507;0;0;0;109531;147168;126507;;;;;;;;
Nationwide Prop & Cas Ins Co;108328;298402;305489;0;0;0;108328;298402;305489;;;;;;;;
Security Natl Ins Co;106147;155033;145915;106147;155033;3609;0;0;142306;;;;;;;;
Standard Fire Ins Co;103375;57744;5507;0;0;0;103375;57744;5507;;;;;;;;
Specialty Risk of Amer;101646;133334;142795;0;0;0;101646;133334;142795;;;;;;;;
Patriot Ins Co;99155;99721;94276;0;0;0;99155;99721;94276;;;;;;;;
Vermont Mut Ins Co;97059;76654;42049;0;0;0;97059;76654;42049;;;;;;;;
Mitsui Sumitomo Ins USA Inc;96213;104200;38253;0;0;0;96213;104200;38253;;;;;;;;
Pennsylvania Manufacturers Assoc Ins;96100;100377;94374;0;0;0;96100;100377;94374;;;;;;;;
Transverse Ins Co;94010;0;0;94010;0;0;0;0;0;;;;;;;;
Westfield Touchstone Ins Co;92481;25199;1920;0;0;0;92481;25199;1920;;;;;;;;
State Farm FL Ins Co;92269;76367;64580;0;0;0;92269;76367;64580;;;;;;;;
American Resources Ins Co Inc;89188;69412;70978;0;0;0;89188;69412;70978;;;;;;;;
Nationwide Mut Fire Ins Co;88998;182017;207403;0;0;0;88998;182017;207403;;;;;;;;
Safety Ins Co;87876;69117;45966;0;0;0;87876;69117;45966;;;;;;;;
Northern Security Ins Co Inc;87082;63375;35276;0;0;0;87082;63375;35276;;;;;;;;
Marysville Mut Ins Co;86929;49742;55110;0;0;0;86929;49742;55110;;;;;;;;
Concord Gen Mut Ins Co;86266;80501;51101;0;0;0;86266;80501;51101;;;;;;;;
Patrons Mut Ins Co Of Ct;85954;107157;137858;0;0;0;85954;107157;137858;;;;;;;;
Trustgard Ins Co;85621;77921;62381;0;0;0;85621;77921;62381;;;;;;;;
Wayne Mut Ins Co;83917;0;0;0;0;0;83917;0;0;;;;;;;;
Puerto Rico Med Defense Mut Ins Co;82452;64416;19583;4538;6519;6783;77914;57897;12800;;;;;;;;
Starnet Ins Co;81563;88601;86636;0;0;0;81563;88601;86636;;;;;;;;
First Ind Ins Of HI Inc;80804;58110;61316;0;0;0;80804;58110;61316;;;;;;;;
Selective Ins Co Of NY;80736;64647;47066;0;0;0;80736;64647;47066;;;;;;;;
Doctors Co An Interins Exch;78280;0;0;0;0;0;78280;0;0;;;;;;;;
KaMMCO Cas Co Inc;78103;112219;45020;0;0;0;78103;112219;45020;;;;;;;;
Westfield Superior Ins Co;77555;18332;1354;0;0;0;77555;18332;1354;;;;;;;;
Norguard Ins Co;77509;40111;6138;0;0;0;77509;40111;6138;;;;;;;;
American Family Home Ins Co;75688;66414;9236;0;0;0;75688;66414;9236;;;;;;;;
Harco Natl Ins Co;73333;275676;366180;0;0;0;73333;275676;366180;;;;;;;;
Cooperativa D Seguros Multiples PR;70317;42756;46455;70317;42756;46455;0;0;0;;;;;;;;
Progressive Northern Ins Co;70132;20397;504;0;0;0;70132;20397;504;;;;;;;;
Southern Mut Ins Co;68590;67643;48050;0;0;0;68590;67643;48050;;;;;;;;
Utica Lloyds Of TX;67961;72032;69692;0;0;0;67961;72032;69692;;;;;;;;
Hallmark Specialty Ins Co;67789;73655;0;0;0;0;67789;73655;0;;;;;;;;
AmTrust Ins Co;67662;97128;93803;67662;97128;0;0;0;93803;;;;;;;;
Hospitality Ins Co;66134;58564;79166;0;0;0;66134;58564;79166;;;;;;;;
Safety Ind Ins Co;65962;45900;28821;0;0;0;65962;45900;28821;;;;;;;;
DTRIC Ins Co Ltd;65768;200693;213781;0;0;0;65768;200693;213781;;;;;;;;
Glencar Ins Co;64782;42115;0;0;0;0;64782;42115;0;;;;;;;;
Mountain States Ind Co;63570;54269;49124;0;0;860;63570;54269;48264;;;;;;;;
Nevada Mut Ins Co Inc;59289;88960;78778;0;0;0;59289;88960;78778;;;;;;;;
Green Mountain Ins Co Inc;56726;47353;22681;0;0;0;56726;47353;22681;;;;;;;;
Union Standard Lloyds;56435;57845;60203;0;0;0;56435;57845;60203;;;;;;;;
Progressive Cas Ins Co;55302;21563;1008;0;0;0;55302;21563;1008;;;;;;;;
Lafayette Ins Co;54574;63840;72468;0;0;0;54574;63840;72468;;;;;;;;
United Fire & Ind Co;54181;64009;70214;0;0;0;54181;64009;70214;;;;;;;;
Medical Providers Mut Ins Co RRG;53181;50071;44289;0;0;0;53181;50071;44289;;;;;;;;
Mercer Ins Co Of NJ Inc;52027;71983;89341;0;0;0;52027;71983;89341;;;;;;;;
Kentucky Hospital Ins Co RRG;52000;55500;45000;0;0;0;52000;55500;45000;;;;;;;;
Citizens Ins Co Of IL;51720;57471;69161;0;0;0;51720;57471;69161;;;;;;;;
Artisan & Truckers Cas Co;49729;27438;5112;0;0;0;49729;27438;5112;;;;;;;;
Meridian Security Ins Co;49384;60563;126232;0;0;0;49384;60563;126232;;;;;;;;
Progressive Specialty Ins Co;46577;30969;977;0;0;0;46577;30969;977;;;;;;;;
New Jersey Manufacturers Ins Co;45672;19433;0;0;0;0;45672;19433;0;;;;;;;;
Old Republic Union Ins Co;44578;57358;90204;30000;30000;30000;14578;27358;60204;;;;;;;;
GuideOne Natl Ins Co;42326;60685;824;0;0;0;42326;60685;824;;;;;;;;
Areca Ins Exch;42060;42060;41435;0;0;0;42060;42060;41435;;;;;;;;
SafePort Ins Co;41729;0;0;0;0;0;41729;0;0;;;;;;;;
Intrepid Ins Co;38870;0;0;0;0;0;38870;0;0;;;;;;;;
Allstate NJ Ins Co;38617;34262;37500;0;0;0;38617;34262;37500;;;;;;;;
Utica Specialty Risk Ins Co;37720;47439;0;0;0;0;37720;47439;0;;;;;;;;
Trumbull Ins Co;36242;52864;68606;0;0;0;36242;52864;68606;;;;;;;;
Farm Family Cas Ins Co;36038;99876;81888;0;0;0;36038;99876;81888;;;;;;;;
United Natl Ins Co;35706;55393;88713;0;0;0;35706;55393;88713;;;;;;;;
Hospitality Mut Ins Co;32867;31791;37611;0;0;0;32867;31791;37611;;;;;;;;
Hartford Ins Co Of The Southeast;31601;47616;60600;0;0;0;31601;47616;60600;;;;;;;;
Rutgers Cas Ins Co;30487;29084;32761;0;0;0;30487;29084;32761;;;;;;;;
American Southern Home Ins Co;30411;29049;6098;0;0;0;30411;29049;6098;;;;;;;;
Progressive MI Ins Co;29664;18707;9184;0;0;0;29664;18707;9184;;;;;;;;
Westfield Premier Ins Co;28826;2435;0;0;0;0;28826;2435;0;;;;;;;;
MedChoice RRG Inc;28493;163049;196322;0;0;0;28493;163049;196322;;;;;;;;
Acceptance Ind Ins Co;28330;21429;7334;0;0;0;28330;21429;7334;;;;;;;;
MSA Ins Co;28190;27581;29313;0;0;0;28190;27581;29313;;;;;;;;
United Farm Family Ins Co;26650;28472;17369;0;0;0;26650;28472;17369;;;;;;;;
NORCAL Specialty Ins  Co;26139;37737;41530;0;0;0;26139;37737;41530;;;;;;;;
American Guar & Liab Ins;24772;50558;115229;0;0;8366;24772;50558;106863;;;;;;;;
Grange Ind Ins Co;22955;23020;19829;0;0;0;22955;23020;19829;;;;;;;;
Progressive Mountain Ins Co;22517;10421;0;0;0;0;22517;10421;0;;;;;;;;
360 Ins Co;22383;0;0;0;0;0;22383;0;0;;;;;;;;
Farmers Mut Fire Ins Co of Salem Cn;22144;44501;45730;0;0;0;22144;44501;45730;;;;;;;;
American European Ins Co;21942;18112;11411;0;0;0;21942;18112;11411;;;;;;;;
Millville Ins Co of NY;21799;12616;0;0;0;0;21799;12616;0;;;;;;;;
Bridgeway Ins Co;21556;3211;0;0;0;0;21556;3211;0;;;;;;;;
Property & Cas Ins Co Of Hartford;21235;29383;39757;0;0;0;21235;29383;39757;;;;;;;;
Ohio Farmers Ins Co;21133;6703;0;0;0;0;21133;6703;0;;;;;;;;
Farmington Cas Co;20262;14445;4028;0;0;0;20262;14445;4028;;;;;;;;
Guideone Amer Ins Co;20190;15702;6998;0;0;0;20190;15702;6998;;;;;;;;
Nova Cas Co;20136;42358;44738;18648;13821;12814;1488;28537;31924;;;;;;;;
Stillwater Ins Co;20048;4866;0;15519;0;0;4529;4866;0;;;;;;;;
St Paul Guardian Ins Co;19661;15389;2291;0;0;0;19661;15389;2291;;;;;;;;
Peninsula Ins Co;19004;23647;20386;0;0;0;19004;23647;20386;;;;;;;;
Progressive Southeastern Ins Co;18758;6959;1064;0;0;0;18758;6959;1064;;;;;;;;
Mesa Underwriters Specialty Ins Co;18748;19721;18341;0;0;0;18748;19721;18341;;;;;;;;
St Paul Mercury Ins Co;18163;15986;17725;0;0;0;18163;15986;17725;;;;;;;;
Harleysville Ins Co of NY;18081;19143;18363;0;0;0;18081;19143;18363;;;;;;;;
Pacific Specialty Ins Co;17700;10123;3270;0;0;0;17700;10123;3270;;;;;;;;
Universal N Amer Ins Co;17385;62635;0;0;0;0;17385;62635;0;;;;;;;;
Milford Cas Ins Co;16825;23947;29951;16825;23947;0;0;0;29951;;;;;;;;
ISMIE Ind Co;16511;30130;60145;0;0;0;16511;30130;60145;;;;;;;;
Ansur Amer Ins;15449;26197;71721;0;0;0;15449;26197;71721;;;;;;;;
WCF Natl Ins Co;14480;2338;0;0;0;0;14480;2338;0;;;;;;;;
Safety Prop & Cas Ins Co;14145;11210;8060;0;0;0;14145;11210;8060;;;;;;;;
Penn Patriot Ins Co;13788;15663;15515;0;0;0;13788;15663;15515;;;;;;;;
Tower Hill Ins Exch;12125;0;0;0;0;0;12125;0;0;;;;;;;;
Progressive Gulf Ins Co;12114;2318;0;0;0;0;12114;2318;0;;;;;;;;
The Woodlands Ins Co;11754;12811;12784;0;0;0;11754;12811;12784;;;;;;;;
Integrity Select Ins Co;10993;10134;9627;0;0;0;10993;10134;9627;;;;;;;;
ProAssurance Amer Mut a RRG;10251;9881;9639;0;0;0;10251;9881;9639;;;;;;;;
American Zurich Ins Co;9356;-7782;62501;0;0;0;9356;-7782;62501;;;;;;;;
Milbank Ins Co;8512;11865;19858;0;0;0;8512;11865;19858;;;;;;;;
Northfield Ins Co;8481;13319;12620;0;0;0;8481;13319;12620;;;;;;;;
Integrity Prop & Cas Ins Co;7273;7360;7407;0;0;0;7273;7360;7407;;;;;;;;
Drive NJ Ins Co;7271;0;0;0;0;0;7271;0;0;;;;;;;;
Progressive Preferred Ins Co;7122;6730;5169;0;0;0;7122;6730;5169;;;;;;;;
Wilshire Ins Co;6908;0;0;0;0;0;6908;0;0;;;;;;;;
Citizens Ins Co Of OH;6770;8016;8561;0;0;0;6770;8016;8561;;;;;;;;
Farmers Mut Hail Ins Co Of IA;6502;4598;2743;0;0;0;6502;4598;2743;;;;;;;;
Progressive HI Ins Corp;6400;3614;2268;0;0;0;6400;3614;2268;;;;;;;;
NCMIC Ins Co;6062;8987;500;0;0;0;6062;8987;500;;;;;;;;
Sonnenberg Mut Ins Assoc;6056;3784;1885;0;0;0;6056;3784;1885;;;;;;;;
The Bar Plan Mut Ins Co;5643;173157;130155;0;0;0;5643;173157;130155;;;;;;;;
Manufacturers Alliance Ins Co;5443;2394;1289;0;0;0;5443;2394;1289;;;;;;;;
Chicago Ins Co;5434;1659;1364;0;0;0;5434;1659;1364;;;;;;;;
Affinity Mut Ins Co;5219;6520;5190;0;0;0;5219;6520;5190;;;;;;;;
Transguard Ins Co Of Amer Inc;4069;2626;4923;0;0;0;4069;2626;4923;;;;;;;;
Acceptance Cas Ins Co;3687;3190;7334;0;0;0;3687;3190;7334;;;;;;;;
New Jersey Cas Ins Co;3423;0;0;0;0;0;3423;0;0;;;;;;;;
New Jersey Ind Ins Co;3278;0;0;0;0;0;3278;0;0;;;;;;;;
Hartford Ins Co Of IL;3169;4292;4399;0;0;0;3169;4292;4399;;;;;;;;
AIX Specialty Ins Co;2881;16699;50033;0;0;0;2881;16699;50033;;;;;;;;
Riverport Ins Co;2866;2835;4000;0;0;0;2866;2835;4000;;;;;;;;
Patriot Gen Ins Co;2529;507;90;0;0;0;2529;507;90;;;;;;;;
Pennsylvania Manufacturers Ind Co;2437;0;205;0;0;0;2437;0;205;;;;;;;;
TDC Natl Assur Co;2150;54441;343634;2150;54441;343634;0;0;0;;;;;;;;
American Natl Lloyds Ins Co;1811;1719;1239;0;0;0;1811;1719;1239;;;;;;;;
Farmers Prop & Cas Ins Co;1568;6087;0;0;0;0;1568;6087;0;;;;;;;;
OBI Natl Ins Co;1535;1024;603;0;0;0;1535;1024;603;;;;;;;;
Safety Northeast Ins Co;1251;0;0;0;0;0;1251;0;0;;;;;;;;
Hallmark Natl Ins Co;1200;1150;0;0;0;0;1200;1150;0;;;;;;;;
Watford Ins Co;1170;678264;744285;0;0;0;1170;678264;744285;;;;;;;;
Ontario Ins Co;1140;380;0;0;0;0;1140;380;0;;;;;;;;
Crestbrook Ins Co;578;0;0;0;0;0;578;0;0;;;;;;;;
Alfa Mut Ins Co;436;387;370;0;0;0;436;387;370;;;;;;;;
Texas Medical Ins Co;410;125070;545470;410;125070;545470;0;0;0;;;;;;;;
New Jersey Re Ins Co;353;0;0;0;0;0;353;0;0;;;;;;;;
Alfa Ins Corp;338;262;170;0;0;0;338;262;170;;;;;;;;
Citizens Ins Co Of The Midwest;227;708;839;0;0;0;227;708;839;;;;;;;;
American Home Assur Co;118;180556;382968;118;180556;382968;0;0;0;;;;;;;;
Tower Hill Prime Ins Co;110;0;0;0;0;0;110;0;0;;;;;;;;
1842 Ins Co;50;0;0;0;0;0;50;0;0;;;;;;;;
Homeowners of Amer Ins Co;43;0;0;0;0;0;43;0;0;;;;;;;;
Foremost Ins Co Grand Rapids MI;-81;-1040;59770;0;0;0;-81;-1040;59770;;;;;;;;
National Interstate Ins Co;-1415;1570;87795;-1415;1570;87795;0;0;0;;;;;;;;
TDC Specialty Ins Co;-3009;1957010;4919491;-3009;1957010;4919491;0;0;0;;;;;;;;
Indemnity Ins Co Of North Amer;-5931;3513362;3995336;0;0;0;-5931;3513362;3995336;;;;;;;;
ProAssurance Specialty Ins Co;-118714;237200;286720;0;0;0;-118714;237200;286720;;;;;;;;
AIG Ins Co PR;0;0;1280568;0;0;1280568;0;0;0;;;;;;;;
ANPAC LA Ins Co;0;12033;8685;0;0;0;0;12033;8685;;;;;;;;
Admiral Ins Co;0;7442452;0;0;0;0;0;7442452;0;;;;;;;;
Aegis Hlthcare RRG Inc;0;131516;93576;0;131516;93576;0;0;0;;;;;;;;
Alfa Alliance Ins Corp;0;0;0;0;0;0;0;0;0;;;;;;;;
AmTrust Ins Co of KS Inc;0;0;0;0;0;0;0;0;0;;;;;;;;
American Automobile Ins Co;0;0;3643;0;0;0;0;0;3643;;;;;;;;
American Economy Ins Co;0;23;1186;0;0;0;0;23;1186;;;;;;;;
American Ins Co;0;0;2743;0;0;0;0;0;2743;;;;;;;;
American Modern Home Ins Co;0;107;2968;0;0;0;0;107;2968;;;;;;;;
American Security Ins Co;0;0;0;0;0;0;0;0;0;;;;;;;;
American States Ins Co;0;0;121;0;0;0;0;0;121;;;;;;;;
Arbella Protection Ins Co;0;0;0;0;0;0;0;0;0;;;;;;;;
Argonaut Ins Co;0;148212;881873;0;0;8873;0;148212;873000;;;;;;;;
Associated Ind Corp;0;0;3281;0;0;0;0;0;3281;;;;;;;;
CMIC RRG;0;0;141777;0;0;0;0;0;141777;;;;;;;;
Campmed Cas & Ind Co Inc;0;0;1;0;0;0;0;0;1;;;;;;;;
Capacity Ins Co;0;23359;0;0;0;0;0;23359;0;;;;;;;;
Cassatt RRG Inc;0;0;0;0;0;0;0;0;0;;;;;;;;
Church Mut Ins Co;0;0;0;0;0;0;0;0;0;;;;;;;;
Clermont Ins Co;0;0;0;0;0;0;0;0;0;;;;;;;;
Colonial Surety Co;0;0;0;0;0;0;0;0;0;;;;;;;;
Colony Ins Co;0;0;0;0;0;0;0;0;0;;;;;;;;
Conifer Ins Co;0;0;0;0;0;0;0;0;0;;;;;;;;
Consolidated Ins Co;0;0;1712;0;0;0;0;0;1712;;;;;;;;
Copperpoint Gen Ins Co;0;1;1465;0;0;0;0;1;1465;;;;;;;;
Copperpoint Ind Ins Co;0;1;816;0;0;0;0;1;816;;;;;;;;
Copperpoint Ins Co;0;945;2999;0;0;0;0;945;2999;;;;;;;;
Copperpoint Mut Ins Co;0;0;0;0;0;0;0;0;0;;;;;;;;
Cumis Ins Society Inc;0;0;0;0;0;0;0;0;0;;;;;;;;
Economy Fire & Cas Co;0;0;3287;0;0;0;0;0;3287;;;;;;;;
Economy Preferred Ins Co;0;0;3104;0;0;0;0;0;3104;;;;;;;;
Emergency Physicians Ins Exchange RR;0;0;0;0;0;0;0;0;0;;;;;;;;
Executive Risk Specialty Ins Co;0;0;0;0;0;0;0;0;0;;;;;;;;
Family Security Ins Co Inc;0;644;1182;0;0;0;0;644;1182;;;;;;;;
Farmland Mut Ins Co;0;0;0;0;0;0;0;0;0;;;;;;;;
Fidelity & Deposit Co Of MD;0;0;1028;0;0;0;0;0;1028;;;;;;;;
First Natl Ins Co Of Amer;0;0;275;0;0;0;0;0;275;;;;;;;;
Firstline Natl Ins Co;0;0;0;0;0;0;0;0;0;;;;;;;;
Foremost Prop & Cas Ins Co;0;-104;2700;0;0;0;0;-104;2700;;;;;;;;
Foremost Signature Ins Co;0;-280;15197;0;0;0;0;-280;15197;;;;;;;;
Franklin Mut Ins Co;0;500918;502412;0;0;0;0;500918;502412;;;;;;;;
GNY Custom Ins Co;0;0;0;0;0;0;0;0;0;;;;;;;;
General Security Natl Ins Co;0;0;61275;0;0;61275;0;0;0;;;;;;;;
Great Midwest Ins Co;0;0;262726;0;0;0;0;0;262726;;;;;;;;
Guideone Mut Ins Co;0;0;239667;0;0;0;0;0;239667;;;;;;;;
Guideone Specialty Mut Ins Co;0;0;41776;0;0;0;0;0;41776;;;;;;;;
HARLEYSVILLE LAKE STATES INS CO;0;0;0;0;0;0;0;0;0;;;;;;;;
HCC Specialty Ins Co;0;0;0;0;0;0;0;0;0;;;;;;;;
Healthcare Underwriters Grp Inc;0;-37;11191;0;0;0;0;-37;11191;;;;;;;;
Imperium Ins Co;0;0;338803;0;0;0;0;0;338803;;;;;;;;
Indiana Ins Co;0;0;2370;0;0;0;0;0;2370;;;;;;;;
Insurance Co Of The State Of PA;0;0;0;0;0;0;0;0;0;;;;;;;;
Integrand Assur Co;0;0;0;0;0;0;0;0;0;;;;;;;;
Integrity Mut Ins Co;0;0;0;0;0;0;0;0;0;;;;;;;;
Iowa Amer Ins Co;0;0;0;0;0;0;0;0;0;;;;;;;;
Iowa Mut Ins Co;0;0;-61;0;0;0;0;0;-61;;;;;;;;
Ironshore Ind Inc;0;0;-2260;0;0;27318;0;0;-29578;;;;;;;;
Ironshore Specialty Ins Co;0;0;652758;0;0;370966;0;0;281792;;;;;;;;
James River Cas Co;0;-535;4166;0;0;0;0;-535;4166;;;;;;;;
Jewelers Mut Ins Co;0;0;0;0;0;0;0;0;0;;;;;;;;
Le Mars Ins Co;0;0;0;0;0;0;0;0;0;;;;;;;;
Loudoun Mut Ins Co;0;0;2800;0;0;0;0;0;2800;;;;;;;;
MD RRG Inc;0;277750;43818;0;277750;43818;0;0;0;;;;;;;;
Maxum Ind Co;0;0;213;0;0;0;0;0;213;;;;;;;;
Mercer Ins Co;0;0;5303;0;0;0;0;0;5303;;;;;;;;
Metropolitan Cas Ins Co;0;0;3630;0;0;0;0;0;3630;;;;;;;;
Metropolitan Drt Prop & Cas Ins Co;0;0;14981;0;0;0;0;0;14981;;;;;;;;
Metropolitan Gen Ins Co;0;0;349;0;0;0;0;0;349;;;;;;;;
Metropolitan Grp Prop & Cas Ins Co;0;0;0;0;0;0;0;0;0;;;;;;;;
Metropolitan Prop & Cas Ins Co;0;0;57226;0;0;0;0;0;57226;;;;;;;;
Mid Hudson CoOp Ins Co;0;252555;251448;0;0;0;0;252555;251448;;;;;;;;
Midwestern Ind Co;0;0;232;0;0;0;0;0;232;;;;;;;;
Motorists Mut Ins Co;0;-75;-7147;0;0;0;0;-75;-7147;;;;;;;;
MountainPoint Ins Co;0;-287;6703;0;0;0;0;-287;6703;;;;;;;;
National Ind Co of Mid Amer;0;0;23856;0;0;23856;0;0;0;;;;;;;;
National Surety Corp;0;0;4326;0;0;0;0;0;4326;;;;;;;;
National Union Fire Ins Co Of Pitts;0;42044612;154820247;0;42044612;154820247;0;0;0;;;;;;;;
Netherlands Ins Co The;0;0;21223;0;0;0;0;0;21223;;;;;;;;
Norcal Mut Ins Co;0;0;1468481;0;0;0;0;0;1468481;;;;;;;;
North Amer Specialty Ins Co;0;22660189;5823635;0;22660189;5823635;0;0;0;;;;;;;;
Oklahoma Specialty Ins Co;0;0;0;0;0;0;0;0;0;;;;;;;;
PACO Assur Co Inc;0;0;0;0;0;0;0;0;0;;;;;;;;
Pacific Prop & Cas Co;0;11231;7776;0;0;0;0;11231;7776;;;;;;;;
Peerless Ins Co;0;0;1316;0;0;0;0;0;1316;;;;;;;;
Phenix Mut Fire Ins Co;0;-65;1149;0;0;0;0;-65;1149;;;;;;;;
Podiatry Ins Co Of Amer;0;0;0;0;0;0;0;0;0;;;;;;;;
Republic Fire & Cas Ins Co;0;270;385;0;270;0;0;0;385;;;;;;;;
Republic Lloyds;0;0;2687;0;0;0;0;0;2687;;;;;;;;
Republic Underwriters Ins Co;0;441;68;0;441;0;0;0;68;;;;;;;;
Secura Ins A Mut Co;0;0;1283056;0;0;0;0;0;1283056;;;;;;;;
Sentry Ins A Mut Co;0;0;1143186;0;0;0;0;0;1143186;;;;;;;;
Sequoia Ins Co;0;0;2877;0;0;0;0;0;2877;;;;;;;;
Sheboygan Falls Ins Co;0;0;0;0;0;0;0;0;0;;;;;;;;
Southern Ins Co;0;0;1331;0;0;0;0;0;1331;;;;;;;;
Southern Trust Ins Co;0;0;74565;0;0;0;0;0;74565;;;;;;;;
St Paul Surplus Lines Ins Co;0;0;34000;0;0;0;0;0;34000;;;;;;;;
UC Hlth RRG a Recip RRG;0;12591;6792;0;0;0;0;12591;6792;;;;;;;;
Underwriters At Lloyds;0;1396392;1330901;0;1396392;1330901;0;0;0;;;;;;;;
United Prop & Cas Ins Co;0;1394;8835;0;0;0;0;1394;8835;;;;;;;;
Universal Ins Co of NA;0;0;42221;0;0;0;0;0;42221;;;;;;;;
Vanliner Ins Co;0;44;25600;0;44;25600;0;0;0;;;;;;;;
Victoria Fire & Cas Co;0;0;0;0;0;0;0;0;0;;;;;;;;
Watford Specialty Ins Co;0;41107;88972;0;0;0;0;41107;88972;;;;;;;;
Wilson Mut Ins Co;0;12;7;0;0;0;0;12;7;;;;;;;;
Wisconsin Municipal Mut Ins Co;0;0;0;0;0;0;0;0;0;;;;;;;;